aMSaBU	a/MSaBU/	aMSaBU/
aMSahara	a/MSahara	aMSahara/
aMsaDrI	a/MsaDrI/	aMsaDrI/
aMhati	aMhati/	aMhati/,a/Mhati,aMha/ti
akarman	akarma/n	a/karman,akarma/n
akAmakarSana	akAma/karSana	a/kAmakarSana
akfta	a/kfta	a/kfta,akfta/
akfzwapacya	a/kfzwapacya/	akfzwapacya/
akza	a/kza,akza/	akza/,a/kza
akzaparAjaya	akza/parAjaya/	akzaparAjaya/
akzarAja	akza/rAja/	akzarAja/
akzita	akzita/,a/kzita	a/kzita
akzi	a/kzi,a/kzi/	a/kzi
akzipat	a/kzipa/t	akzipa/t
akziBU	a/kziBU	akziBU/
akzRayAvan	akzRayA/van	akzRa/yAvan
akzRayAdruh	akzRayA/druh	akzRayAdru/h
agada	agada/	a/gada,agada/
agnicityA	agni/cityA/	agnicityA/
agnicit	agni/ci/t	agnici/t
agnijihva	agni/jihva/	agnijihva/
agnijihvA	agni/jihvA/	agnijihvA/
agnitap	agni/ta/p	agnita/p
agnitapas	agni/ta/pas	agnita/pas
agnitapta	agni/tapta/	agnitapta/
agnidagDa	agni/dagDa,agni/dagDa/	agnidagDa/,agni/dagDa
agniDAna	agni/DA/na	agniDA/na
agninakzatra	agni/nakzatra/	agninakzatra/
agniminDa	agni/minDa/	agniminDa/
agniretasa	agni/retasa/	agniretasa/
agniSAla	agni/SA/la	agniSA/la
agniSiKA	agni/SiKA	agniSiKA/
agniSrI	agni/SrI/	agniSrI/
agnizwoma	agni/zwoma/	agnizwoma/
agnizvAtta	agni/zvAtta/	agnizvAtta/
agnihut	agni/hu/t	agnihu/t
agnihotra	agni/hotra,agni/hotra/	agnihotra/,agni/hotra
agnihotrahut	agni/hotra/hu/t	agnihotrahu/t
agnihotrAhuti	agni/hotrAhuti/	agnihotrAhuti/
agnihotrocCizwa	agni/hotrocCizwa/	agnihotrocCizwa/
agnyupasTAna	agnyupasTA/na	agnyupasTAna/
agrajA	a/grajA,a/grajA/	agrajA/
agrajihva	a/grajihva/	agrajihva/
agratas	a/grata/s,agrata/s	agrata/s
agradiDizu	a/gradiDizu/	agradiDizu/
agrayAvan	a/grayA/van	agrayA/van
agraSas	a/graSa/s	agraSa/s
agrega	agrega/,a/grega/	agrega/
agregU	a/gregU/	agregU/
agreRI	a/greRI/	agreRI/
agrepA	a/grepA/	agrepA/
agrepU	a/grepU	agrepU/
agrevaDa	a/grevaDa/	agrevaDa/
agrya	agrya/	a/grya
aGakft	aGa/kf/t	aGakf/t
aGamAra	aGa/mAra/	aGamAra/
aGarud	aGa/ru/d	aGaru/d
aGaSaMsahan	aGa/SaMsaha/n	aGaSaMsaha/n
aGahAra	aGa/hAra/	aGahAra/
aGnya	a/Gnya	a/Gnya,aGnya/
aNgajvara	a/Ngajvara/	aNgajvara/
aNgaBeda	a/NgaBeda/	aNgaBeda/
aNgirasvat	a/Ngirasvat	aNgirasva/t
acCinnaparRa	a/cCinnaparRa/	a/cCinnaparRa,acCinnaparRa/
acyuta	a/cyuta	a/cyuta,acyuta/
acyutakzit	a/cyutakzi/t	acyutakzi/t
acyutacyut	a/cyutacyu/t	acyutacyu/t
ajagara	aja/gara/	ajagara/
ajatva	aja/tva/	ajatva/
ajapAla	aja/pAla/	ajapAla/
ajabaBru	aja/baBru	a/jabaBru
ajarzaBa	aja/rzaBa/	ajarzaBa/
ajaSfNgI	aja/SfNgI/	ajaSfNgI/
ajma	a/jma	ajma/
ajarya	ajarya/	aja/rya
ajina	aji/na	aji/na,ajina/
ajinavAsin	aji/navAsin	ajinavAsi/n
ajiravatI	ajira/vatI	ajiravatI/
ajrya	ajrya/	ajrya^
aYjisakTa	aYji/sakTa/	aYjisakTa/
atijIva	a/tijIva/	atijIva/
atidAha	a/tidAha/	atidAha/
atipada	a/tipada	atipada/
atimokza	a/timokza/,atimokza/	atimo/kza
atiyAja	a/tiyAja/	atiyAja/
atiSarvara	a/tiSarvara/	atiSarvara/
atigrAhya	atigrAhya/	atigrA/hya
atiGnya	atiGnya/	atiGnya^
atitArya	atitArya/	atitArya^
atiTigva	a/tiTigva/	atiTigva/
atIreka	atIreka/	atIre/ka
atradaGna	a/tradaGna/	atradaGna/
atrin	atri/n	atri/n,a/trin
aTarvI	aTarvI/	aTa^rvI
adantaka	adanta/ka	ada/ntaka,adanta/ka
adititva	a/dititva/	adititva/
adfzwahan	adf/zwaha/n	adfzwaha/n
adDAtamAm	adDA/tamA/m	adDAtamA/m
adyaSvIna	adya/SvIna	adyaSvI/na
adyasutyA	adya/sutyA/	adyasutyA/
adyut	adyu/t	a/dyut
adyUtya	adyUtya/	adyUtya^
adroGavAc	adroGa/vAc	a/droGavAc
aDarAt	a/DarA/t,aDarA/t	a/DarAt,aDarA/t
aDarakaRWa	a/DarakaRWa/	aDarakaRWa/
aDarahanu	a/Darahanu/	aDarahanu/
aDarAk	aDarA/k	aDa/rA/k
aDarAcya	aDarAcya/	aDarAcya^
aDorAma	aDo/rAma	aDo^rAma
aDastAt	aDa/stAt	a/DastAt
aDizavaRya	aDizavaRya/	aDizavaRya^
aDrija	a/Drija	aDri^ja
aDvarakarman	aDvara/karma/n	aDvarakarma/n
aDvarakft	aDvara/kf/t	aDvarakf/t
aDvaraprAyaScitti	aDvara/prAyaScitti	aDvaraprAyaScitti/
aDvaraSrI	aDvara/SrI/,aDvaraSrI/	aDvaraSrI/
anagnatA	a/nagnatA	anagna/tA
anagnitrA	anagni/trA	a/nagnitrA
anagnidagDa	anagni/dagDa	a/nagnidagDa
anativyADya	anativyADya/	anativyADya^
anadDApuruza	a/nadDApuruza/	anadDApuruza/
anapajayyam	a/napajayya/m	anapajayya/m
anaparAdDam	a/naparAdDa/m	anaparAdDa/m
anavaDarzya	anavaDarzya/	anavaDarzya^
anaSanatA	a/naSanatA	anaSana/tA
anaSvadA	anaSva/dA	a/naSvadA
anAgas	a/nAgas,anAga/s	a/nAgas
anAgA	a/nAgA	anAgA/
anAyatana	a/nAyatana	a/nAyatana,anAyatana/
anAvraska	a/nAvraska,anAvraska/	anAvraska/
animizam	a/nimizam,animiza/m	a/nimizam
animiza	animiza/	a/nimiza,animiza/
anila	a/nila	anila/
anIkaSas	a/nIkaSa/s	anIkaSa/s
anukAmakft	anukAma/kf/t	anukAmakf/t
anukUla	anukU/la,anukU/lA	anukU/la
anudrazwavya	anudrazwavya/	anudrazwa/vya
anumAna	anumAna/	anumA/na,anumAna/
anuvAkyA	anuvAkyA/	anuvAkyA^
anuvyam	anuvya/m	anuvya^m
anUkya	anUkya/	anUkya^
anUcya	anUcya/	anUcya^
anUpya	anUpya/	anUpya^
anUbanDya	anUbanDya^	anUba/nDya
anftadviz	a/nftadvi/z	anftadvi/z
anftavAc	a/nftavA/c	anftavA/c
anovAhya	anovAhya/	anovAhya^
antatas	a/ntata/s	antata/s
antakadruh	a/ntakadru/h	antakadru/h
antaHkoSa	anta/HkoSa/	antaHkoSa/
antaHparSavya	anta/HparSavya/	antaHparSavya/
antaHpavitra	anta/Hpavitra/	antaHpavitra/
antaHpAta	anta/HpAta/	antaHpAta/
antaHpAtra	anta/HpAtra/	antaHpAtra/
antaHpArSvya	anta/HpArSvya/	antaHpArSvya/
antaHpeya	anta/Hpe/ya	antaHpe/ya
antaHSleza	anta/HSleza/	antaHSleza/
antaHSlezaRa	anta/HSle/zaRa	antaHSle/zaRa
antaHsadasam	anta/Hsadasa/m	antaHsadasa/m
antaratas	a/ntarata/s,antara/ta/s	antarata/s
antaradiSA	a/ntaradiSA/	antaradiSA/
antarikzaprA	anta/rikzaprA/	antarikzaprA/
antarikzaprut	anta/rikzapru/t	antarikzapru/t
antarikzaloka	anta/rikzaloka/	antarikzaloka/
antarikzasad	anta/rikzasa/d	antarikzasa/d
antarikzasadya	anta/rikzasa/dya	antarikzasa/dya
antaspaTa	anta/spaTa	a/ntaspaTa
antideva	a/ntideva	antideva/,a/ntideva
anDakArita	anDa/kArita	anDakArita/
anDatamasa	anDa/tamasa	anDatamasa/
annAvfD	annAvf/D	annA/vfD
anya	a/nya,anya/	anya/,a/nya
anyakzetra	anya/kzetra/	anyakzetra/
anyarAzwrIya	anya/rAzwrI/ya	anyarAzwrI/ya
anyavApa	anya/vApa/	anyavApa/
anyodarya	anyo/darya	a/nyodarya
anvAhArya	anvAhArya/	anvAhArya^
anvAhAryapacana	anvAhArya/pa/cana	anvAhAryapa/cana
apad	apa/d	a/pad,apa/d
apara	a/para,a/para/	a/para
aparam	a/param	a/param,apara/m
aparaja	a/paraja/	aparaja/
aparapakza	a/parapakza/	aparapakza/
aparapakzIya	a/parapakzIya	aparapakzI/ya
aparapaYcAla	a/parapaYcAla	apara/paYcAla
apararAtra	a/pararAtra/	apararAtra/
aparasakTa	a/parasakTa/	aparasakTa/
apasya	apasya/	apasya^
apAkAt	a/pAkA/t	apAkA/t
apAcya	apAcya/	apAcya^
apAnadA	apAna/dA/	apAnadA/
apAnapA	apAna/pA/	apAnapA/
apAnaBft	apAna/Bf/t	apAnaBf/t
apikakzya	apikakzya/	apikakzya^
apIcya	apIcya/	apIcya^
apunardIyamAna	apuna/rdIyamAna	a/punardIyamAna
apuronuvAkyaka	apuro'nuvAkya/ka	apuro'nuvAkya^ka
apUpamaya	apUpa/maya	apUpama/ya
apUruzaGna	apUruza/Gna	a/pUruzaGna
aprajas	a/prajas	a/prajas,apraja/s
apratirUpa	aprati/rUpa,a/pratirUpa	a/pratirUpa
aprARa	a/prARa	aprARa/
apsu	a/psu,apsu/	a/psu
apsukzit	apsu/kzi/t	apsukzi/t
apsuja	apsu/ja/	apsuja/
apsujA	apsu/jA/	apsujA/
apsujit	apsu/ji/t	apsuji/t
apsuyoga	apsu/yoga/	apsuyoga/
apsuzad	apsu/za/d	apsuza/d
apsuzoma	apsu/zoma/	apsuzoma/
abanDukft	abanDu/kft	a/banDukft
abalya	abalya/	abalya^
abrahman	a/brahman,a/brahma/n	a/brahman,abrahma/n
aBayaMkara	a/BayaMkara/	aBayaMkara/
aBayaMkft	a/BayaMkf/t	aBayaMkf/t
aBayasani	a/Bayasa/ni	aBayasa/ni
aBicakzaRa	aBica/kzaRa	aBi/cakzaRa
aBimAtijit	aBi/mAtiji/t	aBimAtiji/t
aBimAtizAh	aBi/mAtizA/h	aBimAtizA/h
aBimAtizAha	aBi/mAtizAha/	aBimAtizAha/
aBimAtizAhya	aBi/mAtizA/hya	aBimAtizA/hya
aBimAtihan	aBi/mAtiha/n	aBimAtiha/n
aBivAnyA	aBivAnyA/	aBivAnyA^
aByUQi	aByU/Qi	aByU^Qi
aBiSasticAtana	aBi/SasticA/tana	aBiSasticA/tana
aBiSastipA	aBi/SastipA/	aBiSastipA/
aBiSastipAvan	aBi/SastipA/van	aBiSastipA/van
aBizwi	aBizwi/	aBizwi/,aBi/zwi
aBizwikft	aBizwi/kf/t	aBizwikf/t
aBizwipA	aBizwi/pA/	aBizwipA/
aBizwiSavas	aBizwi/Savas	aBi/zwiSavas
aBIruRa	aBI/ruRa	aBIru/Ra
aBIti	aBI/ti	aBI^ti
aBIka	aBI/ka	a/BIka,aBI/ka
aByaYjanya	aByaYjanya/	aByaYjanya^
aByarDayajvan	aByarDa/ya/jvan	aByarDaya/jvan
aByavadAnya	aByavadAnya/	aByavadA/nya
aBrajA	aBra/jA/	aBrajA/
aBrapruz	aBra/pru/z	aBrapru/z
aBrasani	aBra/sa/ni	aBrasa/ni
amati	a/mati,ama/ti	ama/ti,a/mati
amata	a/mata	a/mata,amata/
amAjur	amA/jur	amAju/r
amAvAsya	amA/vAsya/	amAvAsya^,amAvAsya/
amAvAsyaka	amA/vAsyaka	a/mAvAsyaka
amitraKAda	ami/traKAda/	amitraKAda/
amitradamBana	ami/trada/mBana	amitrada/mBana
amitrasenA	ami/trasenA/	amitrasenA/
amitrahan	ami/traha/n	amitraha/n
amutraBUya	amu/traBU/ya	amutraBU/ya
amuTA	amu/TA	amu^TA
amuKa	amuKa/	a/muKa,amuKa/
amftagarBa	amf/tagarBa/	amftagarBa/
amftaciti	amf/taciti	amftaciti/
amftatva	amf/tatva/	amftatva/
amftapakza	amf/tapakza/,amf/tapakza	amftapakza/,amf/tapakza
amftamaya	amf/tama/ya	amftama/ya
amftavAkA	amf/tavA/kA	amftavA/kA
ambara	a/mbara	a/mbara,amba/ra
ambarIza	ambarI/za	amba/rIza,ambarI/za
ayakzmatva	ayakzma/tva/	ayakzmatva/
ayastApa	a/yastApa/	ayastApa/
ayaspAtra	a/yaspAtra/	ayaspAtra/
ayasmaya	a/yasma/ya	ayasma/ya
ayA	a/yA/	ayA/
ayAtayAmatA	a/yAtayAmatA	ayAtayAma/tA
ayoni	a/yoni,ayoni/	a/yoni
araMgara	araMgara/,a/raMgara/	araMgara/
araMGuza	araMGuza/,a/raMGuza/	araMGuza/
araRyenuvAkya	araRye'nuvAkya/	araRye'nuvAkya^
aramamARa	a/ra/mamARa,a/ramamARa	a/ramamARa
araTa	a/raTa/	araTa/
araMkft	a/raMkf/t	araMkf/t
araMgama	a/raMgama/,araMgama/	araMgama/
ararinda	arari/nda	arari^nda
arAqya	arAqya/	arAqya^
arAtidUzaRa	a/rAtidU/zaRa	arAtidU/zaRa
arAtidUzi	a/rAtidU/zi	arAtidU/zi
arAtiha	a/rAtiha/	arAtiha/
arAyakzayaRa	a/rAyakza/yaRa	arAyakza/yaRa
arAyacAtana	a/rAyacA/tana	arAyacA/tana
arAvan	a/rAvan	a/rAvan,arA/van
ari	ari/	ari/,a/ri
arigUrta	ari/gUrta/	arigUrta/
arizwuta	ari/zwuta/	arizwuta/
aritraparaRa	ari/trapa/raRa	aritrapa/raRa
arizwatAti	a/rizwa/tAti	arizwa/tAti
arizwapura	a/rizwapura	arizwa/pura
aruRadUrvA	aruRa/dUrvA/	aruRadUrvA/
aruRapsu	aruRa/psu	aruRapsu/
aruRayuj	aruRa/yu/j	aruRayu/j
arkatva	arka/tva/	arkatva/
arkaSoka	arka/Soka/	arkaSoka/
arkya	arkya/	arkya^
arcatrya	arcatrya/	arca/trya
arDa	a/rDa,arDa/	arDa/,a/rDa
arDaKAra	arDa/KAra	arDaKAra/
arDagarBa	arDa/garBa/	arDagarBa/
arDadeva	arDa/deva/	arDadeva/
arDanAva	arDa/nAva	arDanAva/
arDaBAj	arDa/BAj,arDa/BA/j	arDaBA/j
arDamAsa	arDa/mAsa/	arDamAsa/
arDarca	arDa/rca/	arDarca/
arbuda	a/rbuda,arbuda/	arbuda/
arBa	a/rBa,arBa/	a/rBa
arya	arya/,a/rya	arya/,a/rya,arya^
aryapatnI	a/ryapatnI	arya/patnI
aryamya	aryamya/	aryamya^
arvAksAman	arvA/ksAman	a/rvAksAman
arvAgbila	arvA/gbila	a/rvAgbila
alaMkAra	alaMkAra/	alaMkA/ra,alaMkAra/
alAbupAtra	alA/bupAtra/	alAbupAtra/
alIka	a/lIka	alIka/,a/lIka
alomaka	aloma/ka	alo/maka,aloma/ka
alpameDas	a/lpameDas	alpameDa/s
alpaSas	a/lpaSa/s	alpaSa/s
avataram	a/vatara/m,avatara/m	avatara/m
avawya	avawya/	avawya^
avadyaBI	avadya/BI/	avadyaBI/
avaratas	a/varatas	avarata/s
avaraparam	a/varapara/m	avarapara/m
avarastAt	a/varastAt	avara/stAt
avasAna	a/vasAna,avasA/na	avasA/na,a/vasAna
avasAnadarSa	avasA/nadarSa/	avasAnadarSa/
avasAnya	avasAnya/	avasAnya^
avasvanya	avasvanya/	avasvanya^
avAntaradiS	avAntara/di/S	avAntaradi/S
avAntaradeSa	avAntara/deSa/	avAntaradeSa/
avArapArIRa	avAra/pArIRa	avArapArI/Ra
avArya	avArya/	avArya^,avArya/
avikawa	a/vikawa	avikawa/
avidUsa	a/vidUsa	avidU/sa
avipawa	a/vipawa	avipawa/
avipAla	a/vipAla/	avipAla/
avimarIsa	a/vimarIsa	avimarIsa/
avisoQa	a/visoQa	aviso/Qa
avIra	avI/ra,avI/ra/	avI/ra,avIra/
avIrahan	avI/rahan	a/vIrahan
aSanakft	a/Sanakf/t	aSanakf/t
aSitavya	aSitavya^	aSita/vya
aSastihan	a/Sastiha/n	aSastiha/n
aSezas	aSe/zas	a/Sezas
aSman	a/Sman	a/Sman,aSma/n
aSmanmaya	a/Smanma/ya	aSmanma/ya
aSrama	aSrama/,a/Srama	aSrama/
aSri	a/Sri	a/Sri,aSri/
aSrumuKa	a/SrumuKa/	aSrumuKa/
aSvajit	a/Svajit	aSvaji/t
aSvatara	a/Svatara/,aSvatara/	aSvatara/
aSvatTa	a/SvatTa	aSvatTa/
aSvadA	a/SvadA/	aSvadA/
aSvapa	a/Svapa/	aSvapa/
aSvameDa	a/SvameDa/,a/SvameDa	aSvameDa/,a/SvameDa
aSvayuj	a/Svayuj	aSvayu/j
aSvayUpa	a/SvayUpa/	aSvayUpa/
aSvaraTa	a/SvaraTa/	aSvaraTa/
aSvavid	a/Svavid	aSvavi/d
aSvavfza	a/Svavfza/	aSvavfza/
aSvaSaka	a/SvaSaka/	aSvaSaka/
aSvasani	a/Svasa/ni	aSvasa/ni
aSvasA	a/SvasA/	aSvasA/
aSvasAda	a/SvasAda/	aSvasAda/
aSvastomIya	a/SvastomI/ya	aSvastomI/ya
aSvahaya	a/Svahaya/	aSvahaya/
aSvABiDAnI	aSvABiDA/nI	aSvABiDAnI/
aSvaka	aSvaka/	aSvaka/,a/Svaka
azAQa	a/zAQa	a/zAQa,azA^Qa
azwrAvin	a/zwrAvin	azwrAvi/n
asapatna	a/sapatna,asapatna/,a/sapatna/	asapatna/,a/sapatna
asita	a/sita	a/sita,asita/
asitajYu	a/sitajYu/	asitajYu/
asutfp	a/sutf/p,asutf/p	asutf/p
asurakzayaRa	a/surakza/yaRa	asurakza/yaRa
asuratva	a/suratva/	asuratva/
asuramAyA	a/suramAyA/	asuramAyA/
asurarakzasa	a/surarakzasa/	asurarakzasa/
asurahan	a/suraha/n	asuraha/n
astA	astA/,a/stA	a/stA
astamaya	a/stamaya/	astamaya/
astamayana	a/stama/yana	astama/yana
astamIke	a/stamIke/	astamIke/
astfta	a/stfta,astfta/	a/stfta
asTija	a/sTija/	asTija/
asTisraMsa	a/sTisraMsa/	asTisraMsa/
asnAvaka	asnAva/ka	asnAvaka/
aha	a/ha	a/ha,aha/
ahanya	ahanya/	ahanya^
ahamuttara	aha/muttara/	ahamuttara/
ahamuttaratva	aha/muttara/tva	ahamuttaratva/
ahardfS	a/hardf/S	ahardf/S
aharpati	aharpati/,a/harpa/ti	aharpa/ti
aharBAj	a/harBA/j	aharBA/j
aharvid	a/harvi/d	aharvi/d
ahinirvlayanI	a/hinirvlayanI/	ahinirvlayanI/
ahihatya	a/hiha/tya	ahiha/tya
ahihan	a/hiha/n	ahiha/n
ahIna	a/hIna	ahI/na,a/hIna
AkAyya	AkAyya/	AkAyya^
AkASamaya	AkASa/ma/ya	AkASama/ya
AkUtipra	A/kUtipra/	AkUtipra/
Akenipa	Ake/nipa/	Akenipa/
AKa	A/Ka	AKa/,A/Ka
AKukarIza	AKu/karIza/	AKukarIza/
Agnizwomika	A/gnizwomika	A/gnizwomika,Agnizwomika/
ANgUzya	ANgUzya/	ANgUzya^
AcArya	AcArya/	AcArya^
AcAryaBogIna	AcArya/BogIna	A/cAryaBogIna
Ajikft	Aji/kf/t	Ajikf/t
Ajitur	Aji/tu/r	Ajitu/r
Ajyapa	A/jyapa/	Ajyapa/
Aqambara	Aqa/mbara	Aqamba/ra
AQyakulIna	AQya/kulIna	AQyakulI/na
AQyapadi	AQya/padi	AQyapadi/
Atapa	Atapa/	Atapa/,Ata/pa
Atapya	Atapya/	Atapya^
AtArya	AtArya^,AtArya/	AtArya^
AtiTya	AtiTya/	A/tiTya,AtiTya/
AtiTyarUpa	AtiTya/rUpa/	AtiTyarUpa/
Atura	A/tura	A/tura,Atura/
Atmanvin	Atma/nvi/n	Atmanvi/n
Adya	Adya/	Adya^,A/dya
Adityavani	Aditya/va/ni	Adityava/ni
ADvarika	A/Dvarika	ADvarika/
Ana	Ana/	Ana/,A/na
Apitva	Api/tva/	Apitva/
Apya	A/pya	A/pya,Apya/
AmapAtra	Ama/pAtra/	AmapAtra/
AmikzA	Ami/kzA	Ami/kzA,AmikzA/
Ayu	Ayu/	Ayu/,A/yu
Ayuzak	Ayu/za/k	Ayuza/k
Ayuzya	Ayuzya/	Ayuzya^
ArAttAt	ArA/ttAt	ArA^ttAt
Arkzya	Arkzya/	A/rkzya,Arkzya/
AryakumAra	A/ryakumAra	Arya^kumAra
AryabrAhmaRa	A/ryabrAhmaRa	Arya^brAhmaRa
ArzwizeRa	ArzwizeRa/	A/rzwizeRa
AlApa	A/lApa/	AlApa/
AlaBya	AlaBya^	AlaBya/
AlAwya	AlAwya/	AlAwya^
Avaya	Avaya/	Avaya/,A/vaya
AvirBAva	Avi/rBAva	AvirBAva/
Avya	Avya/	Avya^
ASitaMgavIna	A/SitaMgavIna	ASitaMgavI/na
ASA	ASA/,A/SA	A/SA,ASA/
ASApAla	A/SApAla/	ASApAla/
ASuga	ASu/ga/	ASuga/
ASuMga	ASu/Mga	ASuMga/
ASupatvan	ASu/pa/tvan	ASupa/tvan
ASuheman	ASu/heman	ASuhe/man
ASuhezas	ASu/hezas	ASuhe/zas
ASvapas	ASva/pas	ASva^pas
ASvaSva	ASva/Sva	ASva^Sva
ASvameDa	ASvameDa/	ASvame/Da
ASvina	A/Svina,ASvina/	ASvina/,A/Svina
AspAtra	AspA/tra	AspA/tra,A/spA/tra
Asanya	Asanya/	Asanya^
Asya	Asya/	Asya^
AstaraRa	Asta/raRa	Asta/raRa,AstaraRa/
AsrAvaBezaja	AsrAva/Bezaja/	AsrAvaBezaja/
Ahananya	Ahananya/	Ahananya^
AhArya	AhArya/	AhArya^
iwasUna	i/wasUna/	iwasUna/
iRqva	iRqva/	iRqva^
itarajana	i/tarajana/	itarajana/
iti	i/ti	i/ti,iti/
idAvatsara	idA/vatsara/	idAvatsara/
indraGoza	i/ndraGoza/	indraGoza/
indrajA	i/ndrajA	indrajA/
indrajAla	i/ndrajAla/	indrajAla/
indratanU	i/ndratanU/	indratanU/
indraturIya	i/ndraturIya/	indraturIya/
indraDanus	i/ndraDanu/s	indraDanu/s
indranakzatra	i/ndranakzatra/	indranakzatra/
indrapAtama	i/ndrapAtama	indrapA/tama
indrapAna	i/ndrapA/na	indrapA/na
indramAdana	i/ndramAdana	indramA/dana
indrayoga	i/ndrayoga/	indrayoga/
indraloka	i/ndraloka/	indraloka/
indravAh	i/ndravAh	indravA/h
indrasaMDA	i/ndrasaMDA/	indrasaMDA/
indrasenA	i/ndrasenA/,i/ndrasenA	indrasenA/
indrahava	i/ndrahava/	indrahava/
indrAsomIya	i/ndrAsomI/ya	indrAsomI/ya
iByA	i/ByA	iByA/
iyattaka	i/yattaka/	iyattaka/
iriRya	iriRya/	iriRya^
izavya	izavya/	izavya^
izitatvatA	izita/tva/tA	izitatva/tA
izukAra	i/zukAra/	izukAra/
izukft	i/zukf/t,izukf/t	izukf/t
izuDi	i/zuDi/	izuDi/
izuBft	i/zuBf/t	izuBf/t
izumAtra	i/zumAtra/	izumAtra/
ISAnakft	ISAnakf/t	ISAnakf^t
IzIkA	IzI/kA	I/zIkA
uktapratyukta	ukta/pratyukta/	uktapratyukta/
ukTaBft	ukTa/Bf/t	ukTaBf/t
ukTavarDana	ukTa/va/rDana	ukTava/rDana
ukTaSaMsin	ukTa/SaMsi/n	ukTaSaMsi/n
ukTaSas	ukTa/Sa/s	ukTaSa/s
ukTaSasa	ukTa/Sasa/	ukTaSasa/
ukTya	ukTya/	ukTya^
ukzaRyAyana	ukzaRyA/yana	ukzaRyA^yana
ukzatara	ukza/tara	ukzatara/
ukzavehat	ukza/veha/t	ukzaveha/t
uKacCid	uKa/cCi/d,uKacCi/d	uKacCi/d
ugrajit	ugra/ji/t	ugraji/t
ugraputra	ugra/putra	ugraputra/,ugra/putra
ucaTya	ucaTya/	ucaTya^
uccEstamAm	uccE/stamAm	uccEstamA/m
uttAnaSIvan	uttAna/SI/van	uttAnaSI/van
uttarA	u/ttarA	uttarA/
uttaram	u/ttaram	uttara/m
uttaratas	u/ttarata/s	uttarata/s
uttaradru	u/ttaradru/	uttaradru/
uttaraDurIRa	u/ttaraDurIRa	uttaraDurI/Ra
uttaravedi	u/ttaravedi/	uttaravedi/
uttarasakTa	u/ttarasakTa	uttarasakTa/
uttarahanu	u/ttarahanu/	uttarahanu/
uttarArDya	uttarArDya/	uttarArDya^
utsaDi	u/tsaDi/	utsaDi/
utsya	utsya/	utsya^
utsarga	utsarga/	utsa/rga
udakaBUma	udaka/BUma	udakaBUma/
udanya	udanya/	udanya^
udanyaja	udanya/ja/	udanyaja/
udaktas	u/dakta/s	udakta/s
udIcya	udIcya/	udIcya^
udaradAra	uda/radAra/	udaradAra/
udarya	udarya/	udarya^
udita	u/dita	udita/
uditahomin	u/ditahomi/n	uditahomi/n
udumbara	udumba/ra	udu/mbara
udumbala	udumba/la,udumbala/	udumbala/
udgrahaRa	udgra/haRa	u/dgra/haRa
uddAlakapuzpaBaYjikA	uddA/lakapuzpaBaYjikA	u/ddAlakapuzpaBaYjikA
unmattapralapita	u/nmattapralapita	unmattapralapita/
upajijYAsya	upajijYAsya/	upajijYAsya^
upadeSya	upadeSya/	upadeSya^
upapakzya	upapakzya/	upapakzya^
upasartavya	upasa/rtavya	upasarta/vya
upastuta	u/pastuta	u/pastuta,upastuta/
upasTa	upa/sTa,upasTa/	upa/sTa
upasTadaGna	upa/sTadaGna/	upasTadaGna/
upasTasad	upa/sTasa/d	upasTasa/d
upAkacakzas	u/pAkacakzas	upAka/cakzas
upAtaNkya	upAtaNkya/	upAtaNkya^
uBayaMkara	uBa/yaMkara/	uBayaMkara/
uBayadyus	uBa/yadyu/s	uBayadyu/s
umAkawa	u/mAkawa	umAkawa/
uraRa	u/raRa	u/raRa,uraRa/
urAmaTi	u/rAma/Ti	urAma/Ti
urastas	u/rastas	urasta/s
urukft	uru/kf/t	urukf/t
urukrama	uru/krama/	urukrama/
urukzaya	uru/kzaya	urukza/ya
urukziti	uru/kziti/	urukziti/
urugAya	uru/gAya/	urugAya/
urugUlA	uru/gU/lA	urugU/lA
urugrAha	uru/grAha/	urugrAha/
urucakra	uru/cakra/	urucakra/
urucakri	uru/ca/kri	uruca/kri
urucakzas	uru/ca/kzas	uruca/kzas
urujrayas	uru/jra/yas	urujra/yas
urujri	uru/jri/	urujri/
urupraTas	uru/pra/Tas	urupra/Tas
urubila	uru/bila/	urubila/
urubja	uru/'bja	urubja/
uruvyacas	uru/vya/cas	uruvya/cas
uruvyaYc	uru/vya/Yc	uruvya/Yc
uruSaMsa	uru/Sa/Msa	uruSa/Msa
uruzA	uru/zA	uruzA/
urvyUti	urvyU/ti	urvyU^ti
urvarAjit	urva/rAji/t	urvarAji/t
urvarAsA	urva/rAsA/	urvarAsA/
urvarya	urvarya/	urvarya^
ulapa	u/lapa	u/lapa,ula/pa
ulbaRa	ulba/Ra,ulbaRa/	ulbaRa/
uzasya	uzasya/	uzasya^
UDanya	UDanya/	UDanya^
UrudaGna	Uru/daGna/	UrudaGna/
UruBinna	Uru/Binna	UruBinna/
Urvya	Urvya/,U/rvya	U/rvya
Urjavya	Urjavya/	Urjavya^
UrRAvala	U/rRAvala/	UrRAvala/
UrRAsUtra	U/rRAsUtra/	UrRAsUtra/
UrDvacit	UrDva/ci/t	UrDvaci/t
UrDvabAhu	UrDva/bAhu	UrDva/bA^hu
UrDvasAna	UrDva/sAna/	UrDvasAna/
UzmaRya	UzmaRya/	UzmaRya^
ftacit	fta/ci/t	ftaci/t
ftajA	fta/jA/	ftajA/
ftajAta	fta/jA/ta	ftajA/ta
ftajAtasatya	fta/jA/tasatya	fta/jAtasatya
ftajit	fta/ji/t	ftaji/t
ftajur	fta/ju/r	ftaju/r
ftajYA	fta/jYA	ftajYA/
ftapA	fta/pA/	ftapA/
ftayuj	fta/yuj	ftayu/j
ftavAka	fta/vAka/	ftavAka/
ftavAdin	fta/vAdi/n	ftavAdi/n
ftasad	fta/sa/d	ftasa/d
ftasadana	fta/sa/dana	ftasa/dana
ftastuB	fta/stu/B	ftastu/B
ftasTA	fta/sTA/	ftasTA/
ftaspfS	fta/spf/S	ftaspf/S
ftekarmam	ftekarma/m,fte/karma/m	ftekarma/m
ftugraha	ftu/graha/	ftugraha/
ftupati	ftu/pa/ti	ftupa/ti
ftupA	ftu/pA/	ftupA/
ftupAtra	ftu/pAtra/	ftupAtra/
ftumaya	ftu/ma/ya	ftuma/ya
ftumuKa	ftu/mu/Ka	ftumuKa/
ftuSas	ftu/Sa/s	ftu\Sa/s
ftuzWA	ftu/zWA/	ftuzWA/
ftviya	ftvi/ya	ftvi/ya,f/tviya
fgmiya	fgmi/ya	fgmi/ya,f/gmiya
fjukratu	fju/kratu/	fjukra/tu
fjuga	fju/ga/	fjuga/
fjuDA	fju/DA/	fjuDA/
fjunIti	fju/nIti/	fjunIti/
fjumuzka	fju/muzka/	fjumuzka/
fjuvani	fju/va/ni	fjuva/ni
fjuhasta	fju/ha/sta	fjuha/sta
fjra	fjra/	fjra/,f/jra
fRacit	fRa/ci/t	fRaci/t
fRacyut	fRa/cyu/t	fRacyu/t
fRaMcaya	fRa/Mcaya	fRaMcaya/
fRayA	fRa/yA/	fRayA/
fRayAt	fRa/yAt	fRayA/t
fRayAvan	fRa/yA/van	fRayA/van
fRavan	fRa/va/n	fRava/n
fDak	f/Dak	f/Dak,fDa/k
fSyada	f/Syada/	fSyada/
fzaBatara	fzaBa/tara	fzaBatara/
fzaBadAyin	fzaBa/dAyi/n	fzaBadAyi/n
fzikft	f/zikft	fzikf/t
fzicodana	f/zico/dana	fzico/dana
fzidviz	f/zidvi/z	fzidvi/z
fzivat	f/ziva/t	fziva/t
fzizah	f/zizah	fziza/h
fzisvara	f/zisvara/	fzisvara/
ekaja	e/kaja/	ekaja/
ekatama	e/katama/	ekatama/
ekatara	e/katara	ekatara/
ekatA	e/katA	eka/tA
ekatriMSa	e/katriMSa	ekatriMSa/
ekadevatya	e/kadevatya/	ekadeva/tya
ekadyU	e/kadyU/	ekadyU/
ekaDana	e/kaDana/	ekaDana/,e/kaDana
ekaDanavid	e/kaDana/vi/d	ekaDanavi/d
ekaDanin	e/kaDanin	ekaDani/n
ekaDurIRa	e/kaDurIRa	ekaDu/rIRa
ekanakzatra	e/kanakzatra/	ekanakzatra/
ekapad	e/kapa/d	e/kapad
ekapadi	e/kapadi	ekapadi/
ekapara	e/kapara/	ekapara/
ekayAvan	e/kayA/van	ekayA/van
ekarAj	e/karAj	ekarA/j
ekarAtra	e/karAtra	ekarAtra/
ekarca	e/karca/	ekarca/
ekartu	e/kartu/	ekartu/
ekarzi	e/karzi	ekarzi/
ekavacana	e/kavacana/	ekavacana/
ekavAdyA	e/kavAdyA/	ekavAdyA/
ekaviMSa	e/kaviMSa/	ekaviMSa/
ekaviMSastoma	e/kaviMSa/stoma	ekaviMSa/stoma
ekaviMSatiDA	e/kaviMSatiDA/	ekaviMSatiDA/
ekavIra	e/kavIra/	ekavIra/
ekavft	e/kavf/t	ekavf/t
ekavfza	e/kavfza/	ekavfza/
ekavrAtya	e/kavrAtya/	ekavrAtya/
ekaSAlika	e/kaSAlika	ekaSAlika/
ekazazwa	e/kazazwa/	ekazazwa/
ekasaBa	e/kasaBa/	ekasaBa/
ekasTa	e/kasTa/	ekasTa/
ekahaMsa	e/kahaMsa/	ekahaMsa/
ekAkzara	ekAkzara/	e/kAkzara,ekAkzara/
ekAdaSa	ekAdaSa/,e/kAdaSa	ekAdaSa/
enasvin	e/nasvi/n	enasvi/n
enasya	enasya/	enasya^
evayA	e/vayA/	evayA/
evayAmarut	e/vayA/marut	evayA/marut
evayAvan	e/vayA/van	evayA/van
evaMvid	eva/Mvi/d	evaMvi/d
evaMkratu	eva/Mkratu/	evaMkratu/
ElabakAra	Elaba/kAra/	ElabakAra/
Ezamastana	Eza/mastana	Ezama/stana
okya	okya/	okya^
ojasvin	o/jasvi/n	ojasvi/n
ojasya	ojasya/	ojasya^
odanapAkI	odana/pAkI	odanapAkI/
ozaDija	o/zaDija/	ozaDija/
ozWajAha	o/zWajAha	ozWajAha/
OkzRa	O/kzRa	OkzRa/
Ottaravedika	O/ttaravedika	O^ttaravedika
kakza	ka/kza	ka/kza,kakza/
kakzya	ka/kzya	ka/kzya,kakzya^
kawaprU	ka/waprU	kawaprU/
kaqaMkarIya	kaqa/MkarIya	kaqaMkarI/ya
kaRWadaGna	kaRWa/daGna/	kaRWadaGna/
kaRvajamBana	ka/Rvaja/mBana	kaRvaja/mBana
kadru	ka/dru,kadrU/	ka/dru,kadru/
kanInaka	kanInaka/	kanI/naka
kanyA	kanyA/	kanyA^,kanyA/
kamala	ka/mala	kama/la,ka/mala
kamalaKaRqa	ka/malaKaRqa	kamalaKa/Rqa
kara	kara/	kara/,ka/ra
karaRa	ka/raRa	karaRa/,ka/raRa
karaYjaha	ka/raYjaha/	karaYjaha/
karIra	karI/ra	karI^ra
karRajAha	ka/rRajAha	karRajAha/
karRavezwakIya	ka/rRavezwakIya	karRavezwakI/ya
karRaSUla	ka/rRaSUla/	karRaSUla/
karRaSoBana	ka/rRaSo/Bana	karRaSo/Bana
kartavya	ka/rtavya	karta/vya
karmaRya	karmaRya/	karmaRya^
karvara	ka/rvara	ka/rvara,karvara/
kalaSadir	kala/Sadi/r	kalaSadi/r
kalA	kalA/	ka/lA
kali	ka/li	ka/li,kali/
kavacapASa	ka/vacapASa/	kavacapASa/
kavicCad	kavi/cCa/d	kavicCa/d
kavitva	kavi/tva/	kavitva/
kavitvana	kavi/tvana/	kavitvana/
kavipraSasta	kavi/praSasta/	kavipraSasta/
kavivfDa	kavi/vfDa/	kavivfDa/
kaviSasta	kavi/Sasta/	kaviSasta/
kARqa	kA/Rqa	kA/Rqa,kARqa/
kAmacaraRa	kA/macaraRa/	kAmacaraRa/
kAmacAra	kA/macAra	kAmacAra/
kAmaduGa	kA/madu/Ga	kAmadu/Ga
kAmaDaraRa	kA/maDa/raRa	kAmaDa/raRa
kAmapra	kA/mapra,kA/mapra/	kAmapra/
kAmapraSna	kA/mapraSna/	kAmapraSna/
kAmamaya	kA/mama/ya	kAmama/ya
kAmarUpin	kA/marUpi/n	kAmarUpi/n
kAya	kAya/	kAya/,kA/ya
kAruRya	kAruRya/	kAruRya^
kArya	kArya/	kArya^
kArzmarya	kArzmarya/	kArzmarya^
kASi	kASi/	kA/Si
kAzWa	kAzWa/	kA/zWa
kiMdevatya	kiMdevatya/	kiMdevatya^
kilAsanASana	kilA/sanA/Sana	kilAsanA/Sana
kilAsaBezaja	kilA/saBezaja/	kilAsaBezaja/
kilbizaspft	ki/lbizaspf/t	kilbizaspf/t
kIricodana	kIri/co/dana	kIrico/dana
kIlAla	kIlA/la,kIlA/la/	kIlA/la
kIlAlapA	kIlA/lapA/	kIlAlapA/
kukkuwakanTa	kukkuwa/kanTa	ku/kkuwakanTa
kutsaputra	ku/tsaputra/	kutsaputra/
kutsavatsa	ku/tsavatsa/	kutsavatsa/
kumArahArita	kumAra/hArita/	kumArahArita/
kumudaKaRqa	ku/mudaKaRqa	kumudaKa/Rqa
kumBamaRqUka	kumBa/maRqUka	ku/mBamaRqUka
kurIra	kurI/ra	kurI/ra,ku/rIra
kurukzetra	ku/rukzetra/	kurukzetra/
kurugArhapata	ku/rugArhapata	kuru/gArhapata
kuruSravaRa	ku/ruSra/vaRa	kuruSra/vaRa
kulagopa	ku/lagopa/	kulagopa/
kulyA	kulyA/	kulyA/,kulyA^
kftapUrvin	kfta/pUrvin	kftapUrvi/n
kftasTalA	kfta/sTalA/	kftasTalA/
kfti	kf/ti	kf/ti,kfti/
kftyAkft	kftyA/kf/t	kftyAkf/t
kftyAdUzaRa	kftyA/dU/zaRa	kftyAdU/zaRa
kftyAdUzi	kftyA/dU/zi	kftyAdU/zi
kftsnahfdaya	kftsna/hf/daya	kftsnahf/daya
kfdara	kf/dara	kf/dara,kfdara/
kfDukarRa	kfDu/ka/rRa	kfDuka/rRa
kfpanILa	kfpa/nILa,kf/panILa	kfpa/nILa
kfpA	kf/pA	kfpA/
kfpaRa	kfpaRa/,kfpa/Ra	kfpaRa/,kfpa/Ra,kf/paRa
kfpaRakASin	kfpaRa/kASin	kfpaRakASi/n
kfmuka	kfmuka/	kfmu/ka
kfzwiprA	kfzwi/prA/	kfzwiprA/
kfzwihan	kfzwi/ha/n	kfzwiha/n
kfzRakarRa	kfzRa/ka/rRa	kfzRaka/rRa
kfzRadra	kfzRa/dra/	kfzRadra/
kfzRaprut	kfzRa/pru/t	kfzRapru/t
kfzRaBUma	kfzRa/BUma	kfzRaBUma/
kfzRavizARA	kfzRa/vizARA/	kfzRavizARA/
kfzRaSakuni	kfzRa/Sakuni/	kfzRaSakuni/
kfzRala	kfzRa/la	kfzRala/
ketapU	ke/tapU/	ketapU/
keSajAha	ke/SajAha	keSajAha/
keSadfMhaRa	ke/Sadf/MhaRa	keSadf/MhaRa
keSavapanIya	ke/SavapanIya	keSavapanI/ya
keSavarDana	ke/Sava/rDana	keSava/rDana
kESorya	kE/Sorya	kESorya/
koza	koza/	ko/za,koza/
kOlAlacakra	kOlAla/cakra/	kOlAlacakra/
kOzItakeya	kO/zItakeya	kOzItakeya/
kya	kya/	kya^
kyat	kya/t	kya^t
kratujit	kra/tuji/t	kratuji/t
kratupA	kra/tupA/	kratupA/
kratuprA	kra/tuprA/	kratuprA/
kratuprAvan	kra/tuprA/van	kratuprA/van
kratumaya	kra/tuma/ya	kratuma/ya
kratuvid	kra/tuvi/d	kratuvi/d
kratusTalA	kra/tusTalA/	kratusTalA/
kramaRa	kra/maRa	krama/Ra
kravyavAhana	kravya/vA/hana	kravyavA/hana
krayavikrayika	kraya/vikrayika	kra/yavikrayika
kroDamaya	kro/Dama/ya	kroDama/ya
kroSa	kro/Sa	kroSa/
krUrakarman	krUra/karma/n	krUrakarma/n
krUrakft	krUra/kf/t	krUrakf/t
kva	kva/	kva^
kvala	kva/la	kva^la
kzatraBft	kzatra/Bft	kzatraBf/t
kzatrayoga	kzatra/yoga/	kzatrayoga/
kzatravani	kzatra/va/ni	kzatrava/ni
kzatravarDana	kzatra/va/rDana	kzatrava/rDana
kzatraSrI	kzatra/SrI/	kzatraSrI/
kzamAcara	kzamA/cara/	kzamAcara/
kziptaBezaja	kzipta/Bezaja	kziptaBezaja/
kzipraSyena	kzipra/Syena/	kzipraSyena/
kzIrapAka	kzIra/pAka/	kzIrapAka/
kzIraSrI	kzIra/SrI/	kzIraSrI/
kzuraDAna	kzura/DAna/	kzuraDAna/
kzetrI	kze/trI/	kzetrI/
kzetrajeza	kze/trajeza/	kzetrajeza/
kzetrajYa	kze/trajYa/	kzetrajYa/
kzetravid	kze/travi/d	kzetravi/d
kzetrasADas	kze/trasA/Das,kzetrasA/Das	kzetrasA/Das
kzetriyanASana	kzetriya/nA/Sana	kzetriyanA/Sana
kzEtra	kzE/tra,kzEtra/	kzEtra/,kzE/tra
kzEtrapatya	kzE/trapatya,kzE/trapatya/	kzEtrapatya/,kzE/trapatya
Kajakft	Ka/jakf/t	Kajakf/t
KajaMkara	Ka/jaMkara/	KajaMkara/
Kaqga	Kaqga/	Ka/qga
Karajru	Ka/rajru	Kara/jru
Karamajra	Ka/ramajra/	Karamajra/
KarvavAsin	Karva/vAsi/n	KarvavAsi/n
Kalaja	Ka/laja/	Kalaja/
KalapU	Ka/lapU	KalapU/
KAdihasta	KAdi/hasta	KA/dihasta
KAdira	KAdira/	KA/dira
gaRapAda	gaRa/pAda	ga/RapAda
gaRaSas	gaRa/Sa/s	gaRaSa/s
gaRaSrI	gaRa/SrI/	gaRaSrI/
ganDarvartu	ganDarva/rtu/	ganDarvartu/
gataSrI	gata/SrI	gataSrI/
gayasADana	ga/yasA/Dana	gayasA/Dana
gayasPAna	ga/yasPA/na	gayasPA/na
gartasad	ga/rtasa/d	gartasa/d
gartamit	ga/rtamit	gartami/t
gardaBanAdin	gardaBa/nAdi/n	gardaBanAdi/n
garBakaraRa	ga/rBaka/raRa	garBaka/raRa
garBatva	ga/rBatva/	garBatva/
garBaDa	ga/rBaDa/	garBaDa/
garBaDi	ga/rBaDi/	garBaDi/
gavya	ga/vya	ga/vya,gavya/
gavyA	ga/vyA,gavyA/	gavyA/
gAtuvid	gAtu/vi/d	gAtuvi/d
girvaRasyu	gi/rvaRasyu/	girvaRasyu/
girikzit	giri/kzi/t	girikzi/t
giricara	giri/cara/	giricara/
girija	giri/ja	girija/
giritra	giri/tra/	giritra/
giribuDna	giri/buDna	giribuDna/
giriBraj	giri/Bra/j	giriBra/j
giriSa	giri/Sa	giriSa/
giriSaya	giri/Saya/	giriSaya/
girizWA	giri/zWA/	girizWA/
guruBft	guru/Bf/t	guruBf/t
gulPajAha	gulPa/jAha	gulPajAha/
guhA	guhA/,gu/hA	gu/hA
gfDrasad	gf/Drasa/d	gfDrasa/d
gfhapa	gfha/pa/	gfhapa/
gfhameDa	gfha/meDa/	gfhameDa/
gfhameDin	gfha/meDi/n	gfhameDi/n
gfhameDIya	gfha/meDI/ya	gfhameDI/ya
gfhameDya	gfha/meDya	gfhameDya^
gfharAja	gfha/rAja/	gfharAja/
goajana	go/a/jana	goa/jana
goarGa	go/arGa/	goarGa/
gokzIra	go/kzIra/	gokzIra/
gogozWa	go/gozWa	gogozWa/
goGAta	go/GAta/	goGAta/
goGna	go/Gna/	goGna/
gojA	go/jA/	gojA/
gojit	go/ji/t	goji/t
gotra	go/tra/,gotra/	gotra/
gotraBid	go/tra/Bi/d	gotraBi/d
godA	go/dA,go/dA/	godA/
godAna	go/dAna,go/dA/na,godA/na	godA/na
goduh	go/du/h,godu/h	godu/h
goDA	go/DA/,goDA/	goDA/
goDUma	go/DU/ma,goDU/ma	goDU/ma
gonasa	go/nasa	gonasa/
gopa	go/pa/,gopa/	gopa/
gopavana	go/pa/vana	gopa/vana
gopA	go/pA/,gopA/	gopA/
gopAla	go/pAla/	gopAla/
gopITa	go/pITa/	gopITa/
gopITya	go/pI/Tya	gopI/Tya
gopoza	go/poza/	gopoza/
gobala	go/bala/	gobala/
goBAj	go/BA/j	goBA/j
gomaya	go/ma/ya,go/maya	goma/ya
gomAyu	go/mAyu	go/mAyu,gomAyu/
gomin	go/min	gomi/n
gomfga	go/mfga/	gomfga/
goyuga	go/yuga	goyuga/
gorUpa	go/rUpa/	gorUpa/
golattikA	go/la/ttikA,gola/ttikA	gola/ttikA
govikarta	go/vikarta/	govikarta/
govid	go/vi/d,govi/d	govi/d
govindu	go/vindu/	govindu/
govfza	go/vfza	govfza/
govyacCa	go/vyacCa/	govyacCa/
goSaPa	go/SaPa/	goSaPa/
goSva	go/'Sva/	go'Sva/
gozaRi	go/za/Ri	goza/Ri
gozan	go/za/n	goza/n
gozA	go/zA/	gozA/
gozAdI	go/zAdI/	gozAdI/
gozeDA	go/zeDA/	gozeDA/
gozWa	go/zWa/,go/zWa,gozWa/	gozWa/
gozWaSva	go/zWa/Sva	gozWaSva/
gozWAna	go/zWA/na	gozWA/na
gosattra	go/sattra/	gosattra/
gosava	go/sava/	gosava/
gohan	go/ha/n	goha/n
gOramfga	gOra/mfga/	gOramfga/
gOrasakTa	gOra/sakTa	gOrasakTa/
grahaRI	gra/haRI	grahaRI/
grABa	grABa/	grA/Ba
grAhya	grAhya/	grAhya^
grAmaGozin	grA/maGozi/n	grAmaGozi/n
grAmajit	grA/maji/t	grAmaji/t
grAmaRI	grA/maRI/	grAmaRI/
grAmatakza	grA/matakza	grAmatakza/
grAmatA	grA/matA	grAma/tA
grAmaraTyA	grA/maraTyA	grAmaraTyA/
grAmaRIya	grA/maRIya	grAmaRI/ya
grAmyavAdin	grAmya/vAdi/n	grAmyavAdi/n
GarmaduGa	Garma/du/Ga	Garmadu/Ga
Garmaduh	Garma/du/h	Garmadu/h
GarmapAvan	Garma/pA/van	GarmapA/van
Garmasad	Garma/sa/d	Garmasa/d
GarmastuB	Garma/stu/B	Garmastu/B
Gozin	Gozi/n,Go/zi/n	Gozi/n
Gfta	Gfta/	Gf/ta/
GftakOSika	Gfta/kOSika/	GftakOSika/
Gftaduh	Gfta/du/h	Gftadu/h
GftapAvan	Gfta/pA/van	GftapA/van
GftapU	Gfta/pU/	GftapU/
Gftapfc	Gfta/pf/c	Gftapf/c
GftaprI	Gfta/prI/	GftaprI/
Gftapruz	Gfta/pruz	Gftapru/z
GftaScut	Gfta/Scu/t	GftaScu/t
GftaScyut	Gfta/Scyu/t	GftaScyu/t
GftaSrI	Gfta/SrI/	GftaSrI/
Gftasad	Gfta/sa/d	Gftasa/d
GftastU	Gfta/stU/	GftastU/
GftasnA	Gfta/snA/	GftasnA/
Gftasnu	Gfta/snu/,Gfta/snu	Gftasnu/,Gfta/snu
GrAtavya	GrAtavya^	GrAta/vya
cakramAsaja	cakra/mAsaja/	cakramAsaja/
cakravAka	cakra/vAka/	cakravAka/
cakrasakTa	cakra/sakTa	cakrasakTa/
caRqa	ca/Rqa	caRqa/
caturTa	caturTa/	caturTa/,ca/turTa
camUzad	camU/za/d	camUza/d
carzaRiprA	carzaRi/prA/	carzaRiprA/
citpati	ci/tpa/ti	citpa/ti
citradfSIka	citra/df/SIka	citradf/SIka
cetyA	ce/tyA/	cetyA/
coda	co/da,co/da/	co/da,coda/
codapravfdDa	co/dapravfdDa	coda/pravfdDa
Candasya	Candasya/	Candasya^
CAyAmaya	CAyA/ma/ya	CAyAma/ya
jaGanya	jaGanya/	jaGanya/,jaGanya^
jana	ja/na	ja/na,jana/
janaMsaha	ja/naMsaha/	janaMsaha/
janapada	ja/napada/	janapada/
janaBakza	ja/naBakza/	janaBakza/
janaBft	ja/naBf/t	janaBf/t
janamejaya	ja/namejaya/	janamejaya/
janayopana	ja/nayo/pana	janayo/pana
janarAj	ja/narA/j	janarA/j
janarAjan	ja/narA/jan	janarA/jan
janavAdin	ja/navAdi/n	janavAdi/n
janaSrI	ja/naSrI/	janaSrI/
jani	ja/ni	ja/ni,jani/
janitva	ja/nitva/,ja/nitva	ja/nitva,janitva/
janitvana	ja/nitvana/	janitvana/
janidA	ja/nidA/	janidA/
janiDA	ja/niDA/	janiDA/
jantva	ja/ntva	jantva^
jarA	ja/rA/,jarA/	jarA/
jaradviz	ja/radvi/z,jaradvi/z	jaradvi/z
jaratkakza	ja/ratkakza/	jaratkakza/
jarAyuja	jarA/yuja/,jarAyuja/	jarAyuja/
jalasarasa	jala/sarasa	jalasarasa/
ja|u	ja/|u	ja|u/
javas	ja/vas,java/s	ja/vas
jAtavidyA	jAtavidyA/,jAta/vidyA/	jAtavidyA/
jAtavedasIya	jAta/vedasI/ya	jAtavedasI/ya
jAtya	jA/tya	jAtya^
jAnuprahftika	jA/nuprahftika	jAnuprahftika/
jAmikft	jAmi/kf/t	jAmikf/t
jAmitva	jAmi/tva/	jAmitva/
jAmiSaMsa	jAmi/SaMsa/	jAmiSaMsa/
jAra	jA/ra,jA/ra/	jA/ra,jAra/
jArya	jArya/	jArya^
jihmaSI	jihma/SI	jihmaSI/
jihvAmUla	jihvA/mUla/	jihvAmUla/
jihvAmUlIya	jihvA/mUlIya	jihvAmUlI/ya
jIvagfB	jIva/gfB	jIvagf/B
jIvagraha	jIva/graha/	jIvagraha/
jIvapurA	jIva/purA/	jIvapurA/
jIvaBojana	jIva/Bo/jana	jIvaBo/jana
jIvayAja	jIva/yAja/	jIvayAja/
jIvaloka	jIva/loka/	jIvaloka/
jIvaSaMsa	jIva/SaMsa/	jIvaSaMsa/
jIvitayopana	jIvita/yo/pana	jIvitayo/pana
juhvAsya	juhvA/sya	juhvA^sya
jozavAka	jo/zavAka	jozavAka/
jYAtiputra	jYAti/putra	jYAtiputra/
jYAtimuKa	jYAti/muKa/	jYAti/muKa
jyezWaGnI	jye/zWaGnI/	jyezWaGnI/
jyezWatas	jye/zWata/s	jyezWata/s
jyezWatAti	jye/zWa/tAti	jyezWa/tAti
jyezWayajYa	jye/zWayajYa/	jyezWayajYa/
jyezWarAj	jye/zWarA/j	jyezWarA/j
jyezWavara	jye/zWavara/	jyezWavara/
jyEzWya	jyE/zWya	jyE^zWya
jyAkAra	jyA/kAra/	jyAkAra/
jyAGoza	jyA/Goza/	jyAGoza/
jyApASa	jyA/pASa/	jyApASa/
Jaza	Jaza/	Jaza^
wvala	wva/la	wvala/
tatama	ta/tama	tatama/
tatara	ta/tara	tatara/
takarI	takarI/,ta/karI	takarI/
takman	ta/kman,takma/n	takma/n,ta/kman
taNgalva	taNgalva/	taNgalva^
tatiDA	ta/tiDA/	tatiDA/
tadidarTa	ta/di/darTa	tadi/darTa
tadvaSa	ta/dvaSa/	tadvaSa/
tadvid	ta/dvi/d	tadvi/d
tadAnIm	tadA/nIm	tadA^nIm
tanUkft	tanU/kf/t	tanUkf/t
tanUkfTa	tanU/kfTa/	tanUkfTa/
tanUja	tanU/ja/	tanUja/
tanUtyaj	tanU/tya/j	tanUtya/j
tanUdUzi	tanU/dU/zi	tanUdU/zi
tanUpA	tanU/pA/	tanUpA/
tanUpAna	tanU/pA/na	tanUpA/na
tanUbala	tanU/bala/	tanUbala/
tanUruc	tanU/ru/c	tanUru/c
tanUvaSin	tanU/vaSi/n	tanUvaSi/n
tanti	tanti/	ta/nti,tanti/
tanticara	tanti/cara/	tanticara/
tantipAla	tanti/pAla	ta/ntipAla
tapasvin	ta/pasvi/n	tapasvi/n
taptarahasa	tapta/rahasa	taptarahasa/
taraRitva	tara/Ritva/	taraRitva/
taras	ta/ras,ta/ra/s	ta/ras,tara/s
tarasvin	ta/rasvi/n	tarasvi/n
taru	ta/ru	ta/ru,taru/
tarda	tarda/	ta/rda
talpaSIvan	ta/lpaSI/van	talpaSI/van
tavasya	tavasya/	tavasya^
tAjadBaNga	tAja/dBa/Nga	tAja/dBaNga
tAmraDUmra	tAmra/DUmra/	tAmraDUmra/
tArpya	tArpya/	tArpya^
tirya	tirya/	tirya^
tila	ti/la	tila/
tilakawa	ti/lakawa	tilakawa/
tilatEla	ti/latEla	tilatEla/
tilapiYja	ti/lapiYja	tilapi/Yja
tilapeja	ti/lapeja	tilape/ja
tilamaya	ti/lamaya	tilama/ya
tilamiSra	ti/lamiSra	tila/miSra
tilavatsa	ti/lavatsa	tila/vatsa
tilavratin	ti/lavratin	tilavrati/n
tizya	tizya/	tizya^
tizyapunarvasavIya	tizya/punarvasavIya	tizyapunarvasavI/ya
tIvrasut	tIvra/su/t	tIvrasu/t
tIvrasoma	tIvra/soma/	tIvrasoma/
tura	tura/	tu/ra,tura/
turaMgaskanDa	tura/MgaskanDa	turaMgaskanDa/
turayA	tura/yA/	turayA/
turParItu	turPa/rItu	tu/rParItu
tuvikUrmi	tuvi/kUrmi/	tuvikUrmi/
tuvikza	tuvi/kza/	tuvikza/
tuvikzatra	tuvi/kzatra/	tuvikzatra/
tuvigra	tuvi/gra/,tuvigra/	tuvigra/
tuvigrABa	tuvi/grABa/	tuvigrABa/
tuvigri	tuvi/gri/	tuvigri/
tuvigrIva	tuvi/grI/va	tuvigrI/va
tuvijAta	tuvi/jAta/	tuvijAta/
tuvidyumna	tuvi/dyumna/	tuvidyumna/
tuvinfmRa	tuvi/nfmRa/	tuvinfmRa/
tuviprati	tuvi/prati/	tuviprati/
tuvibADa	tuvi/bADa/	tuvibADa/
tuvimAtra	tuvi/mAtra/	tuvimAtra/
tuvimrakza	tuvi/mrakza/	tuvimrakza/
tuvirADas	tuvi/rA/Das	tuvirA/Das
tuviSuzma	tuvi/Su/zma	tuviSu/zma
tuvizvaRas	tuvi/zvaRa/s	tuvizvaRa/s
tuvizvaRi	tuvi/zva/Ri	tuvizva/Ri
tuvizvan	tuvi/zva/n	tuvizva/n
tURavaDma	tU/RavaDma/	tURavaDma/
tUtuji	tU/tuji,tU/tuji/	tU/tuji
tfRakARqa	tf/RakARqa	tfRakA/Rqa
tfRajamBan	tf/RajamBan	tfRajamBa/n
tfRajalAyukA	tf/RajalAyukA/	tfRajalAyukA/
tfRamaya	tf/Ramaya	tfRama/ya
tfRaskanda	tf/Raskanda/,tfRaskanda/	tfRaskanda/
tftIyasavana	tftI/yasavana/	tftIyasavana/
tfptAMSu	tfptA/MSu	tfptA^MSu
tfpradaMSin	tfpra/daMSi/n	tfpradaMSi/n
tfzucyavas	tfzu/cya/vas	tfzucya/vas
tfzucyut	tfzu/cyu/t	tfzucyu/t
tfzRAmAra	tf/zRAmAra/	tfzRAmAra/
tejasvin	te/jasvi/n	tejasvi/n
tejasya	tejasya/	tejasya^
tyajas	tya/jas,tya/ja/s	tya/jas,tyaja/s
tyAga	tyAga/	tyA/ga
trayastriMSa	tra/yastriMSa/	trayastriMSa/
trayastriMSastoma	tra/yastriMSa/stoma	trayastriMSa/stoma
trayastriMSin	tra/yastriMSi/n	trayastriMSi/n
trayIvida	trayI/vida/	trayIvida/
trayodaSa	tra/yodaSa,tra/yodaSa/	trayodaSa/
trayodaSaDA	tra/yodaSaDA/	trayodaSaDA/
trayoviMSatiDA	tra/yoviMSatiDA/	trayoviMSatiDA/
trikakud	tri/kaku/d	trikaku/d
trikakuB	tri/kaku/B	trikaku/B
tricatura	tri/catura	tricatura/
tricatvAriMSa	tri/catvAriMSa	tricatvAriMSa/
tricit	tri/ci/t	trici/t
triRava	tri/Rava/	triRava/
tridaSa	tri/daSa	tridaSa/
tridiva	tri/diva/	tridiva/
trinavata	tri/navata	trinavata/
trinAka	tri/nAka/	trinAka/
tripaYcASa	tri/paYcASa/	tripaYcASa/
tripad	tri/pa/d	tripa/d
tripuruza	tri/puruza,tri/puruza/	tripuruza/
triBuj	tri/Bu/j	triBu/j
triBUma	tri/BUma	triBUma/
trirAtra	tri/rAtra/	trirAtra/
trivatsa	tri/vatsa/	trivatsa/
trivartu	tri/va/rtu	triva/rtu
trivft	tri/vf/t	trivf/t
trivfttA	tri/vf/ttA	trivf/ttA
triSata	tri/Sata/	triSata/
triSIrzan	tri/SIrza/n	triSIrza/n
triSukra	tri/Sukra	triSukra/,tri/Sukra
triSuc	tri/Su/c	triSu/c
triSoka	tri/So/ka	triSo/ka
trizaMyukta	tri/zaMyukta/	trizaMyukta/
trizaDasTa	tri/zaDasTa/	trizaDasTa/
trizapta	tri/zapta/	trizapta/
trizazwa	tri/zazwa	trizazwa/
trizwupCandas	tri/zwu/pCandas	trizwu/pCandas
trizwuB	tri/zwu/B	trizwu/B
trizWa	tri/zWa/	trizWa/
trizWin	tri/zWi/n	trizWi/n
trisaptata	tri/saptata	trisaptata/
triMSattama	triMSa/ttama/	triMSattama/
tristAvA	tri/stAvA	tristAvA/
trEvaRIya	trE/vaRIya	trEvaRI/ya
tryakzara	trya/kzara	trya^kzara
tryaNgula	tryaNgula/,trya/Ngula/	tryaNgula/
tryaNgya	tryaNgya/	tryaNgya^
tryambaka	trya/mbaka	trya^mbaka
tryaruRa	trya/ruRa	trya^ruRa
tryaruza	trya/ruza	trya^ruza
tryAvft	tryA/vft	tryA^vft
tryASir	tryA/Sir	tryA^Sir
tvAyA	tvAyA/	tvA/yA
tvacasya	tvacasya/	tvacasya^
tvezya	tvezya/	tvezya^
dakza	da/kza	dakza/,da/kza
dakzakratu	da/kzakratu/	da/kzakratu
dakzavfD	da/kzavfD	dakzavf/D
dakzasADana	da/kzasA/Dana	dakzasA/Dana
dakziRA	da/kziRA	dakziRA/
dakziRAt	da/kziRAt	dakziRA/t
dakziRatas	da/kziRata/s	dakziRata/s
dakziRataskaparda	da/kziRata/skaparda	dakziRata/skaparda
dakziRatrA	da/kziRatrA/	dakziRatrA/
dakziRaDurIRa	da/kziRaDurIRa	dakziRaDurI/Ra
dakziRasad	da/kziRasa/d	dakziRasa/d
dakziRya	dakziRya/	dakziRya^
daDikrA	da/DikrA/	daDikrA/
daDikrAvan	da/DikrA/van	daDikrA/van
daDiGarma	da/DiGarma/	daDiGarma/
dantajAha	da/ntajAha	dantajAha/
dantamUla	da/ntamUla	dantamUla/
dama	da/ma	dama/
darBamaya	darBa/ma/ya	darBama/ya
darBamUlI	darBa/mUlI	darBamUlI/
darvihoma	da/rvihoma/	darvihoma/
darSataSrI	darSata/SrI/	darSataSrI/
daSoRi	da/S'oRi,da/SoRi	da/SoRi
daSama	daSama/	daSama/,da/Sama
dasyutarhaRa	da/syuta/rhaRa	dasyuta/rhaRa
dasyuhatya	da/syuha/tya	dasyu/hatya
dasyuhan	da/syuha/n	dasyuha/n
dAna	dAna/,dA/na	dA/na,dAna/
dAnakAma	dAna/kAma	dA/nakAma
dAvan	dAva/n	dAva/n,dA/van
dAtra	dA/tra	dAtra/,dA/tra
dAnu	dA/nu	dA/nu,dAnu/
dAnuda	dA/nuda/	dAnuda/
dAnupinva	dA/nupinva/	dAnupinva/
dAkzAyaRayajYa	dAkzAyaRa/yajYa/	dAkzAyaRayajYa/
dAkziRaSAla	dAkziRa/SAla	dA/kziRaSAla
dArupAtra	dA/rupAtra/	dArupAtra/
dAruRa	dAruRa/,dA/ruRa	dAruRa/
dAvapa	dAva/pa/	dAvapa/
dASa	dA/Sa	dASa/,dA/Sa
dAsya	dAsya/	dAsya^
didfkzeRya	didf/kze/Rya	didfkze/Rya
didfkzeya	didf/kze/ya	didfkze/ya
dina	dina/,di/na	di/na
divit	di/vi/t	divi/t
divAkara	di/vAkara/	divAkara/
divAkIrtya	di/vAkIrtya/	divAkIrtya^
divAtana	di/vAtana	divA/tana
divikzit	divi/kzit	divikzi/t
divijA	divi/jA/	divijA/
diviyaj	divi/ya/j	diviya/j
diviSrit	divi/Sri/t	diviSri/t
divizad	divi/za/d	diviza/d
divizwamBa	divi/zwamBa/	divizwamBa/
divispfS	divi/spfS	divispf/S
divya	di/vya	divya/
dIkzitavimita	dIkzita/vimita/	dIkzitavimita/
dIrGajihvya	dIrGa/jihvya	dIrGajihvya^
dIrGayATa	dIrGa/yATa/	dIrGayATa/
dIrGaSrut	dIrGa/Sru/t	dIrGaSru/t
dIrGasattra	dIrGa/sattra/	dIrGasattra/
duHKajAta	duHKa/jAta	duHKajAta/
duDrakft	duDra/kf/t	duDrakf/t
dunduBya	dunduBya/	dunduBya^
duroRayu	duroRa/yu/	duroRayu/
duroRasad	duroRa/sa/d	duroRasa/d
durita	du/rita/	durita/
duriti	duriti/	du/riti
durRAmahan	durRA/maha/n	durRAmaha/n
durhaRAyu	durha/RAyu/	durhaRAyu/
duvas	duva/s,du/vas	du/vas,duva/s
dUtya	dUtya/	dUtya^
dUratas	dUra/ta/s	dUrata/s
dfSIkA	df/SIkA/	dfSIkA/
dfSIku	df/SIku/	dfSIku/
devakarma	deva/karma/	devakarma/
devakoSa	deva/koSa/	devakoSa/
devagaRa	deva/gaRa/	devagaRa/
devagfha	deva/gfha/	devagfha/
devaMgama	deva/Mgama/	devaMgama/
devacakra	deva/cakra/	devacakra/
devacCandasa	deva/cCandasa/	devacCandasa/
devaja	deva/ja/	devaja/
devajana	deva/jana/	devajana/
devajA	deva/jA/	devajA/
devajAta	deva/jAta,deva/jAta/	deva/jAta,devajAta/
devajAmi	deva/jAmi	deva/jAmi,devajAmi/
devajUti	deva/jUti	de/vajUti
devatrA	deva/trA/	devatrA/
devatva	deva/tva/	devatva/
devadattaka	deva/dattaka	de/vadattaka
devadUta	deva/dUta/	devadUta/
devanakzatra	deva/nakzatra/	devanakzatra/
devanid	deva/ni/d	devani/d
devapada	deva/pada/	devapada/
devapAtra	deva/pAtra/	devapAtra/
devapAna	deva/pA/na	devapA/na
devapIyu	deva/pIyu/	devapIyu/
devapurA	deva/purA	devapurA/
devamaRi	deva/maRi/	devamaRi/
devamAdana	deva/mA/dana	devamA/dana
devamAna	deva/mAna/	devamAna/
devayaj	deva/ya/j	devaya/j
devayajana	deva/ya/jana	devaya/jana
devayaji	deva/yaji	devaya/ji
devayajYa	deva/yajYa/	devayajYa/
devayajya	deva/ya/jya	devayajya^
devayA	deva/yA/	devayA/
devayAjin	deva/yAjin	devayAji/n
devayAna	deva/yA/na	devayA/na
devayAvan	deva/yA/van	devayA/van
devayoni	deva/yoni	devayoni/
devaloka	deva/loka/	devaloka/
devavaDa	deva/vaDa/	devavaDa/
devavanda	deva/vanda/	devavanda/
devavAhana	deva/vAhana	devavA/hana
devavid	deva/vi/d	devavi/d
devaviS	deva/vi/S	devavi/S
devavI	deva/vI/	devavI/
devavrata	deva/vrata/	devavrata/
devavratin	deva/vratin	devavrati/n
devaSas	deva/Sas	devaSa/s
devaSrI	deva/SrI	devaSrI/
devaSrut	deva/Sru/t	devaSru/t
devaSrU	deva/SrU/	devaSrU/
devasad	deva/sa/d	devasa/d
devasadana	deva/sa/dana	devasa/dana
devasumati	deva/sumati/	devasumati/
devasU	deva/sU	devasU/
devasUda	deva/sUda	devasU/da
devastut	deva/stu/t	devastu/t
devahavis	deva/havi/s	devahavi/s
devahU	deva/hU	devahU/
devahUya	deva/hU/ya	devahU/ya
devaheqana	deva/he/qana	devahe/qana
devaheti	deva/heti/	devaheti/
devatya	devatya/	devatya^
devIMDiyaka	devI/MDiyaka	de/vIMDiyaka
devIrApasaka	devI/rApasaka	de/vIrApasaka
devya	devya/	devya^
dozaRya	dozaRya/	dozaRya^
dohas	do/has	doha/s,do/has
dohita	do/hita	dohita/
dohin	do/hin	dohi/n
dyukza	dyu/kza/	dyukza/
dyukzavacas	dyu/kza/vacas	dyukza/vacas
dyugat	dyu/ga/t	dyuga/t
dyAvApfTivIya	dyA/vApfTivI/ya	dyAvApfTivI/ya
dyumnavarDana	dyumna/va/rDana	dyumnava/rDana
dyutadyAman	dyu/tadyAman	dyuta/dyAman
dyutAna	dyu/tAna/	dyutAna/
dravat	dra/vat,drava/t	drava/t
dravaccakra	drava/cca/kra	drava/ccakra
dravi	dra/vi/	dravi/
drazwavya	drazwavya/	drazwa/vya
drApi	drApi/	drA/pi
druGaRa	dru/GaRa/	druGaRa/
druRasa	dru/Rasa	druRasa/
drupada	dru/pada/	drupada/
druzad	dru/za/d	druza/d
druzadvan	dru/zadvan	druza/dvan
drvanna	drva/nna	drva^nna
drogDavya	drogDavya/	drogDa/vya
droGavAc	dro/GavA/c	droGavA/c
droRakalaSa	dro/RakalaSa/	droRakalaSa/
droRacit	dro/Raci/t	droRaci/t
droRasAc	dro/RasA/c	droRasA/c
dvAdaSa	dvAdaSa/,dvA/daSa	dvAdaSa/
dvAdaSaDA	dvA/daSaDA/	dvAdaSaDA/
dvAdaSarca	dvA/daSarca/	dvAdaSarca/
dvArapAlika	dvA/rapAlika	dvArapAlika/
dvArapiDAna	dvA/rapiDA/na	dvArapiDA/na
dvidevatya	dvidevatya/	dvideva/tya
dvEtavana	dvE/tavana/,dvEtavana/	dvEtavana/,dvE/tavana
DanakAmya	Da/nakAmya/	DanakAmya/
Danajit	Da/naji/t	Danaji/t
DanaMjaya	Da/naMjaya/	DanaMjaya/
DanadA	Da/nadA,Da/nadA/	DanadA/
DanapAla	Da/napAla/	DanapAla/
DanaBakza	Da/naBakza/	DanaBakza/
Danasani	Da/nasa/ni	Danasa/ni
DanasA	Da/nasA/	DanasA/
Danaspft	Da/naspf/t	Danaspf/t
Danu	Da/nu	Danu/,Da/nu
DanuzkAra	DanuzkA/ra	DanuzkAra/
Danvanya	Danvanya/	Danvanya^
Darmakft	Da/rmakft	Darmakf/t
Darmamaya	Da/rmamaya	Darmama/ya
DarmasU	Da/rmasU/	DarmasU/
DAnA	DA/nA/,DAnA/	DAnA/
DAnAsoma	DAnA/soma/	DAnAsoma/
DAnya	DAnya/	DAnya^
DAnyatilvila	DAnya/tilvila	DAnya^tilvila
DArAvara	DA/rAvara/	DArAvara/
DIjavana	DI/ja/vana	DIja/vana
DIjU	DI/jU/	DIjU/
DIrya	DI/rya,DIrya/	DI/rya,DIrya^
DurA	Du/rA,DurA/	DurA/
DfzRvojas	DfzRvo/jas	DfzRvo^jas
Druvakzit	Druva/kzi/t	Druvakzi/t
Druvagopa	Druva/gopa/	Druvagopa/
Druvacyut	Druva/cyu/t	Druvacyu/t
Druvasad	Druva/sa/d	Druvasa/d
Druvi	Druvi/	Dru/vi
Dvanya	Dvanya/	Dvanya^
natarAm	na/tarA/m	natarA/m
nanu	na/nu,nanu/	nanu/
namura	na/mura/	namura/
nahi	na/hi/,nahi/	nahi/
naktaMjAta	na/ktaMjAta/	naktaMjAta/
nakzatrajA	na/kzatrajA/	nakzatrajA/
nakzatradarSa	na/kzatradarSa/	nakzatrada/rSa
nakzatraloka	na/kzatraloka/	nakzatraloka/
naKajAha	naKa/jAha	naKajAha/
naKaleKaka	naKa/leKaka	na/KaleKaka
nagara	na/gara	nagara/
nagnajit	nagna/ji/t	nagnaji/t
nadIpati	nadI/pati/	nadIpati/
nadIvft	nadI/vf/t	nadIvf/t
naBanya	naBanya/	naBanya^
naBasmaya	na/Basma/ya	naBasma/ya
naBasya	naBasya/	naBasya^
naBorUpa	na/BorUpa,na/BorUpa/	na/BorUpa
namaskAra	na/maskAra/	namaskAra/
namasvin	na/masvi/n	namasvi/n
namasya	namasya/	namasya^
naraskanDa	na/raskanDa	naraskanDa/
naladI	na/ladI/	naladI/
navagat	na/vaga/t	navaga/t
navajA	na/vajA/	navajA/
navajvAra	na/vajvAra/	navajvAra/
navadAva	na/vadAva/	navadAva/
navadAvya	na/vadAvya/	navadAvya^
navama	na/vama/,navama/	navama/
navasU	na/vasU/	navasU/
navadaSa	na/vadaSa/	navadaSa/
navaDA	na/vaDA/	navaDA/
navarca	na/varca/	navarca/
nazwavedana	nazwa/ve/dana	nazwave/dana
nahuzya	nahuzya/	nahuzya^
nAkapAla	nA/kapAla/	nAkapAla/
nAkasad	nA/kasa/d	nAkasa/d
nAga	nAga/	nA/ga
nATavid	nATa/vi/d	nATavi/d
nAnAraTam	nA/nAraTa/m	nAnAraTa/m
nAmaTA	nA/ma/TA	nAma/TA
nArizWa	nA/rizWa/	nArizWa/
nArya	nArya/	nA/rya
nAvya	nAvya/	nAvya^
nistarIka	ni/starIka	nistarIka/
nistriMSa	ni/striMSa	nistriMSa/
nikAma	nikAma/,ni/kAma	ni/kAma,nikAma/
nikoSya	nikoSya/	nikoSya^
nigrABya	nigrABya/	nigrABya^
nidAna	nidAna/,nidA/na	nidA/na
niDAnya	niDAnya/	niDAnya^
niDigopa	niDi/gopa/	niDigopa/
niDipA	niDi/pA/	niDipA/
nindya	nindya/	ni/ndya
nimezatas	nimeza/ta/s	nimezata/s
niyutvatIya	niyu/tvatI/ya	niyutvatI/ya
nirdAha	nirdAha/	nirdA/ha
nirbADya	nirbADya/	nirbADya^
nirmaTya	nirmaTya/	nirmaTya^
nividDAna	nivi/dDA/na	nividDA/na
niziktapA	ni/ziktapA/	niziktapA/
nizwarkya	nizwarkya/	nizwarkya^
nItamiSra	nIta/miSra/	nItamiSra/
nIlanaKa	nI/lanaKa/	nIlanaKa/
nIlalohita	nI/lalohita/	nIlalohita/
nIviBArya	nIviBArya/	nIviBArya^
nfcakzas	nf/ca/kzas	nfca/kzas
nfjit	nf/ji/t	nfji/t
nfpati	nf/pa/ti	nfpa/ti
nfpatnI	nf/pa/tnI	nfpa/tnI
nfpARa	nf/pA/Ra	nfpA/Ra
nfpAyya	nf/pA/yya	nfpA/yya
nfpeSas	nf/pe/Sas	nfpe/Sas
nfbAhu	nf/bAhu/	nfbAhu/
nfmaRas	nf/ma/Ras	nfma/Ras
nfmAdana	nf/mA/dana	nfmA/dana
nfmeDa	nf/meDa,nf/me/Da	nfme/Da
nfvat	nf/va/t	nfva/t
nfvatsaKi	nf/va/tsaKi	nfva/tsaKi
nfvAhaRa	nf/vA/haRa	nfvA/haRa
nfvAhas	nf/vA/has	nfvA/has
nfSaMsa	nf/SaMsa	nf/SaMsa,nfSa/Msa
nfSastra	nf/Sastra/	nfSastra/
nfzad	nf/za/d	nfza/d
nfzadana	nf/za/dana	nfza/dana
nfzadman	nf/za/dman	nfza/dman
nfzadvan	nf/za/dvan	nfza/dvan
nfzah	nf/za/h	nfza/h
nfzahya	nf/za/hya	nfza/hya
nfzA	nf/zA/	nfzA/
nfzAti	nf/zA/ti	nf/zAti
nfhan	nf/ha/n	nfha/n
nfmRavarDana	nfmRa/va/rDana	nfmRava/rDana
nfti	nfti/	nfti/,nf/ti
nErbADya	nErbADya/	nErbADya^
nyakta	nya/kta	nya^kta
nyaYc	nya/Yc	nya^Yc
nyarbuda	nya/rbuda	nya^rbuda
nyarbudi	nya/rbudi	nya^rbudi
nyahna	nyahna/	nya/hna
nyUna	nyU/na	nyU^na
pakzahata	pakza/hata/	pakzahata/
pakzya	pakzya/	pakzya^
paNkajinI	pa/NkajinI	paNkaji/nI
pacatya	pacatya/	pacatya^
patitva	pa/titva/	patitva/
patitvana	pa/titvana/	patitvana/
patidviz	pa/tidvi/z	patidvi/z
patirip	pa/tiri/p	patiri/p
patiloka	pa/tiloka/	patiloka/
patividya	pa/tivi/dya	pativi/dya
pativedana	pa/tive/dana	pative/dana
pativratA	pa/tivratA	pati/vratA
patnISAlA	pa/tnISAlA	patnISA/lA
patnIsaMyAja	pa/tnIsaMyAja/	patnIsaMyAja/
padanuzaNga	pa/danuzaNga/	padanuzaNga/
padGoza	pa/dGoza/	padGoza/
padanI	pada/nI/	padanI/
padayopana	pada/yo/pana	padayo/pana
padavAya	pada/vAya/	padavAya/
padavid	pada/vi/d	padavi/d
padavI	pada/vI/	padavI/
padavIya	pada/vI/ya	padavI/ya
padazWIva	pada/zWIva	padazWIva/
padAji	padA/ji	padAji/
payaspA	pa/yaspA/	payaspA/
payasvin	pa/yasvin	payasvi/n
paratas	pa/ratas	parata/s
paratva	pa/ratva/	paratva/
parArDya	parArDya/	parArDya^
paramajA	parama/jA/	paramajA/
paramajyA	parama/jyA/	paramajyA/
parastaram	para/stara/m	parastara/m
parastarAm	para/starA/m	parastarA/m
parastAt	pa/rastAt	para/stAt
paraspA	para/spA/	paraspA/
parovaram	paro'vara/m	parovara/m
paraSu	paraSu/	paraSu/,pa/raSu
parAtaram	pa/rAtara/m	parAtara/m
parAvat	pa/rAva/t	parAva/t
parivitta	pa/rivitta	pa/rivitta,parivitta/
parivargya	parivargya/	parivargya^
parivfkta	pa/rivfkta/	pa/rivfkta
parizadvala	pariza/dvala	parizadvala/
paruza	paruza/,paru/za	paruza/
parRaDi	parRa/Di/	parRaDi/
parRamaRi	parRa/maRi/	parRamaRi/
parRamaya	parRa/ma/ya	parRama/ya
parRavI	parRa/vI/	parRavI/
parRaSada	parRa/Sada/	parRaSada/
parRaSadya	parRa/Sadya/	parRaSadya^
parRya	parRya/	pa/rRya
parvatacyut	pa/rvatacyu/t	parvatacyu/t
parvatya	parvatya/	parvatya^
palASaSAtana	palASa/SAtana	palASaSA/tana
palvalya	palvalya/	palvalya^
paSavya	paSavya/	paSavya^
paSvekAdaSinI	paSve/kAdaSinI	paSve^kAdaSinI
paScArDya	paScArDya/	paScArDya^
paScAtkarRam	paScA/tkarRa/m	paScAtkarRa/m
paScAtsad	paScA/tsa/d	paScAtsa/d
pastya	pastya/	pastya^
pastyasad	pastya/sa/d	pastyasa/d
pAna	pA/na	pA/na,pAna/
pAMsavya	pAMsavya/	pAMsavya^
pAka	pA/ka	pA/ka,pAka/
pAkatrA	pA/katrA/	pAkatrA/
pAkadUrvA	pA/kadUrvA/	pAkadUrvA/
pAkayajYa	pA/kayajYa,pAkayajYa/	pAkayajYa/
pAkavat	pA/kava/t	pAkava/t
pAkaSaMsa	pA/kaSaMsa	pAkaSaMsa/
pAkasutvan	pA/kasu/tvan	pAkasu/tvan
pANktatva	pA/Nktatva/	pANktatva/
pAjasya	pAjasya/	pAjasya^
pARiGna	pARi/Gna/	pARiGna/
pARya	pARya/	pARya^
pARqukambalin	pARqu/kambalin	pARqukambali/n
pARquBUma	pARqu/BUma	pARquBUma/
pARqva	pARqva/	pARqva^
pAtalya	pAtalya/	pAtalya^
pAdya	pA/dya	pA/dya,pAdya^
pApakArin	pApa/kArin	pApakAri/n
pApakft	pApa/kf/t	pApakf/t
pApakftyA	pApa/kftyA/	pApakftyA/
pApakftvan	pApa/kf/tvan	pApakf/tvan
pApatva	pApa/tva/	pApatva/
pApayakzma	pApa/yakzma/	pApayakzma/
pApaloka	pApa/loka/	pApaloka/
pApavasyasa	pApa/vasyasa/	pApavasyasa/
pApavAda	pApa/vAda/	pApavAda/
pApasama	pApa/sa/ma	pApasa/ma
pArAvataGnI	pA/rAvataGnI/	pArAvataGnI/
pArSvatas	pArSva/ta/s	pArSvata/s
pAzya	pAzya/	pAzya^
pitukft	pitu/kf/t	pitukf/t
pituBAj	pitu/BA/j	pituBA/j
pituzaRi	pitu/za/Ri	pituza/Ri
pitfbanDu	pitf/banDu	pitfbanDu/
pitfBogIRa	pitf/BogIRa	pitfBogI/Ra
pitfyajYa	pitf/yajYa/	pitfyajYa/
pitfyARa	pitf/yA/Ra	pitfyA/Ra
pitfloka	pitf/loka/	pitfloka/
pitfvat	pitf/vat,pitf/va/t	pitfva/t
pitfvitta	pitf/vitta/	pitfvitta/
pitfSravaRa	pitf/Sra/vaRa	pitfSra/vaRa
pitfzad	pitf/za/d	pitfza/d
pitfzadana	pitf/za/dana	pitfza/dana
pitfhUya	pitf/hU/ya	pitfhU/ya
pizwamaya	pizwa/maya	pizwama/ya
pucCaDi	pu/cCaDi/	pucCaDi/
puRyakft	pu/Ryakf/t	puRyakf/t
puRyakftyA	pu/RyakftyA/	puRyakftyA/
puRyajana	pu/Ryajana/	puRyajana/
puRyarAtra	pu/RyarAtra	puRyarAtra/
puRyasama	pu/Ryasa/ma	puRyasa/ma
putrakAmyA	putra/kAmyA/	putrakAmyA/
putrakfTa	putra/kfTa/	putrakfTa/
putrapOtrIRa	putra/pOtrIRa	putrapOtrI/Ra
putramaya	putra/ma/ya	putrama/ya
putravala	putra/vala	putravala/
putravidya	putra/vidya	putravi/dya
punarasu	pu/narasu/	punarasu/
punarADeya	pu/narADe/ya	punarADe/ya
punarAlamBa	pu/narAlamBa/	punarAlamBa/
punarutsfzwa	pu/narutsfzwa/	punarutsfzwa/
punarutsyUta	pu/narutsyUta/	punarutsyUta/
punarnizkfta	pu/narnizkfta/	punarnizkfta/
punarBU	pu/narBU	puna/rBU/
punarmanya	pu/narmanya/	punarmanya/
punarmftyu	pu/narmftyu/	punarmftyu/
punaryajYa	pu/naryajYa/	punaryajYa/
punarhan	pu/narha/n	punarha/n
purARavat	purARa/va/t	purARava/t
purARavid	purARa/vi/d	purARavi/d
puronuvAkyA	puro'nuvAkyA/	puro'nuvAkyA^
purohan	puro/han	puroha/n
purIzavAhaRa	pu/rIzavA/haRa	purIzavA/haRa
purIzya	purIzya/	purIzya^
purukutsa	puru/ku/tsa	puruku/tsa
purukutsAnI	puru/ku/tsAnI	puruku/tsAnI
purukft	puru/kf/t	purukf/t
purukftvan	puru/kf/tvan	purukf/tvan
purukzu	puru/kzu/	purukzu/
purugUrta	puru/gUrta/	purugUrta/
purucetana	puru/ce/tana	puruce/tana
purujAta	puru/jAta/	purujAta/
puruRITa	puru/RITa/	puruRITa/
purutman	puru/tma/n	purutma/n
purutrA	puru/trA/	purutrA/
purudaMsas	puru/da/Msas	puruda/Msas
purudama	puru/da/ma	puruda/ma
purudasma	puru/dasma/	purudasma/
purudina	puru/di/na	purudi/na
purudrapsa	puru/drapsa/	purudrapsa/
purudruh	puru/dru/h	purudru/h
puruDa	puru/Da/	puruDa/
puruDapratIka	puru/Da/pratIka	puruDa/pratIka
puruniHziD	puru/niHzi/D	puruniHzi/D
puruniHziDvan	puru/niHziDvan	puruniHzi/Dvan
purunizWa	puru/nizWa	purunizWa/
purunfmRa	puru/nfmRa/	purunfmRa/
puruputra	puru/putra/	puruputra/
purupeSa	puru/pe/Sa	purupe/Sa
purupeSas	puru/pe/Sas	purupe/Sas
puruprajAta	puru/prajAta/	puruprajAta/
purupraSasta	puru/praSasta/	purupraSasta/
purupriya	puru/priya/	purupriya/
puruprEza	puru/prE/za	puruprEza/,puruprE/za
puruBU	puru/BU/	puruBU/
puruBojas	puru/Bo/jas	puruBo/jas
purumantu	puru/ma/ntu	puruma/ntu
purumandra	puru/mandra/	purumandra/
purumAya	puru/mAya/	purumAya/
purumAyya	puru/mA/yya	purumA/yya
purumitra	puru/mitra/	purumitra/
purumeDa	puru/me/Da	purume/Da
purumeDas	puru/me/Das	purume/Das
pururaTa	puru/ra/Ta	purura/Ta
pururAvan	puru/rA/van	pururA/van
pururuc	puru/ru/c	pururu/c
pururUpa	puru/rUpa	pururU/pa
puruvartman	puru/va/rtman	puruva/rtman
puruvarpas	puru/va/rpas	puruva/rpas
puruvAja	puru/vA/ja	puruvA/ja
puruvAra	puru/vA/ra	puruvA/ra
puruvArapuzwi	puru/vA/rapuzwi	puruvA/rapuzwi
puruvIra	puru/vI/ra	puruvI/ra
puruvepas	puru/ve/pas	puruve/pas
puruvrata	puru/vrata/	puruvrata/
puruSAka	puru/SA/ka	puruSA/ka
puruScandra	puru/Scandra/	puruScandra/
puruzanti	puru/za/nti	puruza/nti
puruzwuta	puru/zwuta/	puruzwuta/
puruspArha	puru/spArha/	puruspArha/
puruspfh	puru/spfh	puruspf/h
puruhUta	puru/hUta/	puruhUta/
puruzacCandasa	pu/ruzacCandasa/	puruzacCandasa/
puruzatA	pu/ruza/tA	puruza/tA
puruzatrA	pu/ruzatrA/	puruzatrA/
puruzamAtra	pu/ruzamAtra/	puruzamAtra/
puruzamfga	pu/ruzamfga/	puruzamfga/
puruzameDa	pu/ruzameDa/	puruzameDa/
puruzarAja	pu/ruzarAja/	puruzarAja/
puruzarUpa	pu/ruzarUpa	puruzarUpa/
puruzarezaRa	pu/ruzare/zaRa	puruzare/zaRa
puruzavaDa	pu/ruzavaDa/	puruzavaDa/
puruzavAc	pu/ruzavA/c	puruzavA/c
puruzavyAGra	pu/ruzavyAGra/	puruzavyAGra/
puruzaSIrza	pu/ruzaSIrza/	puruzaSIrza/
puruzya	puruzya/	puruzya^
puzkaraparRa	pu/zkaraparRa/	puzkaraparRa/
puzkarasAda	pu/zkarasAda/	puzkarasAda/
puzwapati	puzwa/pa/ti	puzwapa/ti
puzwi	pu/zwi	puzwi/
puzwipati	pu/zwipa/ti	puzwipa/ti
puzwivarDana	pu/zwiva/rDana	puzwiva/rDana
puzpakarRa	pu/zpaka/rRa	puzpaka/rRa
pUtabanDana	pUta/ba/nDana	pUtaba/nDana
pUtaBft	pUta/Bf/t	pUtaBf/t
pUtiganDa	pU/tiganDa/,pU/tiganDa	pUtiganDa/
pUtiganDi	pU/tiganDi	pUtiganDi/
pUtirajju	pU/tirajju/	pUtirajju/
pUrRadarva	pUrRa/darva/	pUrRadarva/
pUrRapAtra	pUrRa/pAtra/	pUrRapAtra/
pUrvakft	pU/rvakf/t	pUrvakf/t
pUrvagatvan	pU/rvaga/tvan	pUrvaga/tvan
pUrvacit	pU/rvaci/t	pUrvaci/t
pUrvacitti	pUrva/citti	pU/rvacitti
pUrvaja	pU/rvaja/	pUrvaja/
pUrvajana	pU/rvajana/	pUrvajana/
pUrvajAvan	pU/rvajA/van	pUrvajA/van
pUrvaTA	pU/rvaTA	pUrva/TA
pUrvapakza	pU/rvapakza/	pUrvapakza/
pUrvapakzIya	pU/rvapakzIya	pUrvapakzI/ya
pUrvapA	pU/rvapA/	pUrvapA/
pUrvapAYcAlaka	pU/rvapAYcAlaka	pUrva/pAYcAlaka
pUrvapARinIya	pU/rvapARinIya	pUrva/pARinIya
pUrvapAyya	pU/rvapA/yya	pUrvapA/yya
pUrvapIti	pU/rvapIti	pUrva/pIti
pUrvapeya	pU/rvape/ya	pUrvape/ya
pUrvaprajYA	pU/rvaprajYA/	pUrvaprajYA/
pUrvaBAj	pU/rvaBA/j	pUrvaBA/j
pUrvayAyAta	pU/rvayAyAta	pUrva/yAyAta
pUrvayAvan	pU/rvayA/van	pUrvayA/van
pUrvarAtra	pU/rvarAtra/	pUrvarAtra/
pUrvavat	pU/rvavat,pUrvava/t	pUrvava/t
pUrvavayasa	pU/rvavayasa/	pUrvavayasa/
pUrvavayasin	pU/rvavayasi/n	pUrvavayasi/n
pUrvavah	pU/rvava/h	pUrvava/h
pUrvasakTa	pU/rvasakTa/	pUrvasakTa/
pUrvasad	pU/rvasa/d	pUrvasa/d
pUrvasU	pU/rvasU/	pUrvasU/
pUrvahUti	pU/rvahUti	pUrva/hUti
pUrvahoma	pU/rvahoma/	pUrvahoma/
pftanAj	pf/tanAj	pftanA/j
pftanAjit	pf/tanAji/t	pftanAji/t
pftanAjya	pf/tanAjya	pftanA/jya
pftanAzah	pf/tanAzah	pftanAza/h
pftanAzAhya	pf/tanAzA/hya	pftanAzA/hya
pftanAhava	pf/tanAha/va	pftanAha/va
pfTavAna	pfTa/vAna	pf/TavAna
pfTivImaya	pfTivI/ma/ya	pfTivIma/ya
pfTugman	pfTu/gma/n	pfTugma/n
pfTujraya	pfTu/jra/ya	pfTujra/ya
pfTujrayas	pfTu/jra/yas	pfTujra/yas
pfTupakzas	pfTu/pa/kzas	pfTupa/kzas
pfTuparSu	pfTu/pa/rSu	pfTupa/rSu
pfTupAjas	pfTu/pA/jas	pfTupA/jas
pfTubuDna	pfTu/buDna	pfTu/buDna,pfTubuDna/
pfTuSravas	pfTu/Sra/vas	pfTuSra/vas
pfSanAyu	pf/SanAyu/	pfSanAyu/
pfSnitva	pf/Snitva/	pfSnitva/
pfSnisakTa	pf/SnisakTa/	pfSnisakTa/
pfSnihan	pf/Sniha/n	pfSniha/n
pfzwivah	pfzwi/va/h	pfzwiva/h
pfzWajAha	pfzWa/jAha	pfzWajAha/
pfzWatas	pfzWa/ta/s	pfzWata/s
pfzWayajvan	pfzWa/ya/jvan	pfzWaya/jvan
pfzWya	pfzWya/,pf/zWya/	pfzWya^,pfzWya/
peSI	pe/SI	peSI/
peSaskArI	pe/SaskArI/	peSaskArI/
potra	potra/	potra/,po/tra
praugya	praugya/	praugya^
praGAsya	praGAsya/	praGAsya^
prajApatiloka	prajA/patiloka/	prajApatiloka/
prajAvid	prajA/vi/d	prajAvi/d
prajAsani	prajA/sa/ni	prajAsa/ni
pratikAmya	pratikAmya/	pratikAmya^
pratijanya	prati/janya	pra/tijanya
pratipuruzam	pratipuruza/m	pratipu/ruzam
pratihitAyin	pra/tihitAyi/n	pratihitAyi/n
pratisarya	pratisarya/	pratisarya^
pratira	pratira/,prati/ra	pratira/
pratnavat	pratnava/t,pratna/vat	pratnava/t
pratIcInaPala	pratIcIna/Pala	pratIcI/naPala
pratIcya	pratI/cya	pratIcya^
pratyavarUQi	pratyava/rUQi	pratya/varUQi
praTamacCad	praTama/cCa/d	praTamacCa/d
praTamaja	praTama/ja/	praTamaja/
praTamaBAj	praTama/BA/j	praTamaBA/j
praTamayajYa	praTama/yajYa/	praTamayajYa/
praTamavayasin	praTama/vayasi/n	praTamavayasi/n
praTamavAsya	praTama/vAsya/	praTamavAsya^
praTamaSravas	praTama/Sravas	praTamaSra/vas
pradavya	pradavya/	pradavya^
pradAvya	pradAvya/	pradAvya^
praDanya	praDanya/	praDanya^
prapaTin	pra/paTi/n	prapaTi/n
prapaTya	pra/paTya/	prapaTya^
praBfti	pra/Bfti	praBf/ti,pra/Bfti
pravat	prava/t,pra/vat	prava/t
prozya	prozya/	prozya^
pravAhya	pravAhya/	pravAhya^
pravAyya	pravAyya/	pravAyya^
pravargya	pravargya/	pravargya^
pravyADa	pra/vyADa/	pravyADa/
praSastikft	pra/Sastikft	praSastikf/t
praSnavivAka	praSna/vivAka/	praSnavivAka/
prazwivAhin	pra/zwivAhin	prazwivAhi/n
prasava	prasava/,pra/sava	prasava/
prasTiti	pra/sTiti	prasTi/ti,pra/sTiti
prahAyya	prahAyya/	prahAyya^
praheya	pra/he/ya	prahe/ya
prahArya	prahArya/	prahA/rya
prAyAsa	prAyAsa/	prA/yAsa
prAvAhaReya	prA/vAhaReya	prAvAhaReya/
prAcInayogIputra	prAcI/nayogIpu/tra	prA/cInayogIpu/tra
prAcyasaptasama	prAcya/saptasama	prA/cyasaptasama
prARagraha	prARa/graha/	prARagraha/
prARada	prARa/da/	prARada/
prARadfh	prARa/dfh	prARadf/h
prARapata	prARa/pata	prARapata/
prARapA	prARa/pA/	prARapA/
prARaBft	prARa/Bf/t	prARaBf/t
prARamaya	prARa/ma/ya	prARama/ya
prASavya	prASavya/	prASavya^
prASitavya	prASitavya^	prASita/vya
prASitraharaRa	prASitra/ha/raRa	prASitraha/raRa
prASuzah	prASu/za/h	prASuza/h
prASnIputra	prA/SnIputra/	prA/SnIpu/tra
priyaDA	priya/DA/	priyaDA/
priyavAdin	priya/vAdi/n	priyavAdi/n
priyasa	priya/sa/	priyasa/
prozWapada	pro/zWapada/	prozWapada/
prozWapAda	pro/zWapAda	prozWapAda/
plASi	plASi/	plA/Si
Palagrahi	Pa/lagra/hi	Palagra/hi
Palgva	Palgva/	Palgva^
banDukzit	ba/nDukzi/t	banDukzi/t
banDutA	ba/nDu/tA	banDutA/
banDupfC	ba/nDupf/C	banDupf/C
banDura	ba/nDura	banDura/
baBruka	baBruka/,ba/Bruka/	baBruka/,ba/Bruka
barjahya	barjahya/	barjahya^
barhizya	barhizya/	barhizya^
bala	bala/	ba/la
balAkAkOSika	balA/kAkOSika/	balAkAkOSika/
balihAra	bali/hAra/	balihAra/
balihft	bali/hft	balihf/t
bahukulIna	bahu/kulIna	bahukulI/na
bahukfta	bahu/kfta	bahukfta/
bahugu	bahu/gu/	bahugu/
bahucArin	bahu/cAri/n	bahucAri/n
bahutiTa	bahu/tiTa	bahutiTa/
bahutrA	bahu/trA/	bahutrA/
bahudAna	bahu/dAna,bahu/dAna/	bahudAna/
bahudevatya	bahu/devatya	bahudevatya^
bahuDA	bahu/DA,bahuDA/	bahuDA/
bahuDmAta	bahu/DmAta/	bahuDmAta/
bahuparRa	bahu/parRa/	bahuparRa/
bahupAyya	bahu/pA/yya	bahupA/yya
bahuyAjin	bahu/yAjin	bahuyAji/n
bahurasa	bahu/rasa/	bahurasa/
bahurUpa	bahu/rUpa/	bahurUpa/
bahuvacana	bahu/vacana	bahuvacana/
bahuvAdin	bahu/vAdi/n	bahuvAdi/n
bahuvid	bahu/vi/d	bahuvi/d
bahuSas	bahu/Sas,bahuSa/s	bahuSa/s
bahuSAKa	bahu/SAKa	bahuSAKa/
bahusAra	bahu/sAra/	bahusAra/
bahuhastika	bahu/hasti/ka	bahuhasti/ka
bahuhiraRya	bahu/hiraRya/	bahuhiraRya/
bAQasftvan	bAQa/sf/tvan	bAQasf/tvan
bAlya	bA/lya	bAlya/
bAhava	bAha/va	bAha/va,bAhava/
bAhukzad	bAhu/kza/d	bAhukza/d
bAhucyut	bAhu/cyu/t	bAhucyu/t
bAhutA	bAhu/tA/	bAhu/tA
bAhubalin	bAhu/bali/n	bAhubali/n
bAhumAtra	bAhu/mAtra/	bAhumAtra/
bAhuvIrya	bAhu/vIrya/	bAhuvIrya^
bAhuvfkta	bAhu/vfkta/	bAhuvfkta/
bAhuSarDin	bAhu/SarDi/n	bAhuSarDi/n
bAhvojas	bAhvo/jas	bAhvo^jas
bilaDAvana	bi/laDA/vana	bilaDA/vana
bilva	bilva/	bilva^
bisaKA	bi/saKA/	bisaKA/
buDnya	buDnya/	buDnya^
bfhajjAla	bfha/jjAla/	bfhajjAla/
bfhadukz	bfha/du/kz	bfhadu/kz
bfhaddivA	bfha/ddivA/	bfhaddivA/
bfhadraTa	bfha/draTa/	bfhadraTa/
bfhaspatisava	bf/haspa/tisava/	bfhaspatisava/
bElvamaya	bElva/maya	bElvama/ya
brahman	bra/hman	bra/hman,brahma/n
brahmajUta	brahmajU/ta	bra/hmajUta
brahmaRya	brahmaRya/	brahmaRya^
brahmaRvat	bra/hmaRvat,brahmaRva/t	brahmaRva/t
brAhmakfteya	brAhma/kfteya	brAhmakfteya/
brAhmaguptIya	brAhma/guptIya	brAhmaguptI/ya
brAhmadattAyana	brAhma/dattAyana	brAhmadattAyana/
brAhmaRajAta	brA/hmaRajAta/	brAhmaRajAta/
brAhmaRatrA	brA/hmaRatrA	brAhmaRatrA/
brAhmaRayajYa	brA/hmaRayajYa/	brAhmaRayajYa/
brAhmaRavarcasa	brA/hmaRavarcasa/	brAhmaRavarcasa/
brAhmaRAcCaMsya	brAhmaRAcCaMsya/	brAhmaRAcCaMsya^
BaktakaMsa	Bakta/kaMsa	Ba/ktakaMsa
Bagevita	Ba/ge'vita	Ba/gevita
Badrakft	Badra/kf/t	Badrakf/t
BadrapAda	Badra/pAda	BadrapAda/
BadramuKa	Badra/muKa	BadramuKa/
BadravAcya	Badra/vA/cya	BadravAcya^
BadravAdin	Badra/vAdi/n	BadravAdi/n
BadraSrut	Badra/Sru/t	BadraSru/t
Badrasena	Badra/sena/	Badrasena/
BayabrAhmaRa	Baya/brAhmaRa	Ba/yabrAhmaRa
Bartavya	Bartavya^	Ba/rtavya
Bavitavya	Bavitavya^	Bavita/vya
Basadya	Basadya/	Basadya^
BAmin	BAmi/n	BA/min
BAga	BAga/	BA/ga,BAga/
BAgadA	BAga/dA/	BAgadA/
BAgaduGa	BAga/duGa/	BAgaduGa/
BAgaDa	BAga/Da/	BAgaDa/
BAgaDeya	BAga/De/ya	BAgaDe/ya
BAraBArin	BAra/BArin	BAraBAri/n
BAraBft	BAra/Bf/t	BAraBf/t
BArya	BArya/	BArya^
BikzAmARava	BikzA/mARava	Bi/kzAmARava
BikzAvAsas	BikzA/vAsas	Bi/kzAvAsas
Bikzitavya	Bikzitavya^	Bikzita/vya
Bujizya	Bujizya/	Bujizya^
Buvanacyava	Bu/vanacyava/	Buvanacyava/
Buvanasad	Bu/vanasa/d	Buvanasa/d
BUtakft	BUta/kf/t	BUtakf/t
BUtapati	BUta/pa/ti	BUtapa/ti
BUtayajYa	BUta/yajYa	BUtayajYa/
BUtavid	BUta/vi/d	BUtavi/d
BUtasaMkrAmin	BUta/saMkrAmi/n	BUtasaMkrAmi/n
BUtasADana	BUta/sA/Dana	BUtasA/Dana
BUyaskft	BU/yaskft	BUyaskf/t
BUridA	BU/ridA/	BUridA/
BUridAvan	BU/ridA/van	BUridA/van
BUripozin	BU/ripozi/n	BUripozi/n
BUriSas	BU/riSas	BUriSa/s
BUrizah	BU/riza/h	BUriza/h
Bfmi	Bfmi/	Bf/mi,Bfmi/
Bezajya	Bezajya/	Bezajya^
Boga	Boga/	Boga/,Bo/ga
BojakawIya	Boja/kawIya	BojakawI/ya
BOvAyana	BOvAyana/	BOvA/yana
BrAjasvin	BrA/jasvin	BrAjasvi/n
BrAtftva	BrA/tftva/	BrAtftva/
BrAtfvala	BrA/tfvala	BrAtfvala/
BrAtfvyakzayaRa	BrA/tfvyakza/yaRa	BrAtfvyakza/yaRa
BrAtfvyaGnI	BrA/tfvyaGnI/	BrAtfvyaGnI/
BrAtfvyacAtana	BrA/tfvyacA/tana	BrAtfvyacA/tana
BrAtfvyahan	BrA/tfvyaha/n	BrAtfvyaha/n
BrURahatyA	BrURa/hatyA/	BrURahatyA/
BrURahan	BrURa/han	BrURaha/n
makara	ma/kara	maka/ra
maKahan	maKa/ha/n	maKaha/n
maGadeya	maGa/de/ya	maGade/ya
maGavattva	maGa/vattva/	maGavattva/
maRikAra	maRi/kAra/	maRikAra/
maRigrIva	maRi/grIva/	maRigrIva/
maRivAla	maRi/vA/la	maRivA/la
maRqUkasarasa	maRqU/kasarasa	maRqUkasarasa/
matya	matya/	matya^
matsyahan	ma/tsyaha/n	matsyaha/n
maTavya	maTavya/	maTavya^
madacyut	ma/dacyu/t	madacyu/t
maDavya	maDavya/	maDavya^
maDukaSA	ma/DukaSA/	maDukaSA/
maDukulyA	ma/DukulyA/	maDukulyA/
maDukft	ma/Dukf/t	maDukf/t
maDugraha	ma/Dugraha/	maDugraha/
maDuduGa	ma/Dudu/Ga	maDudu/Ga
maDudoGa	ma/DudoGa/	maDudoGa/
maDuDA	ma/DuDA/	maDuDA/
maDupa	ma/Dupa/	maDupa/
maDuparka	ma/Duparka/	maDuparka/
maDuparkya	ma/Duparkya	maDuparkya/
maDupU	ma/DupU/	maDupU/
maDupfc	ma/Dupf/c	maDupf/c
maDupeya	ma/Dupe/ya	maDupe/ya
maDumiSra	ma/DumiSra/	maDumiSra/
maDuvAhana	ma/DuvA/hana	maDuvA/hana
maDuvfD	ma/Duvf/D	maDuvf/D
maDuvfza	ma/Duvfza/	maDuvfza/
maDuScut	ma/DuScu/t	maDuScu/t
maDyA	ma/DyA,maDyA/	maDyA/
maDyatas	ma/Dyata/s	maDyata/s
maDyarAtra	ma/DyarAtra/	maDyarAtra/
maDyamavAh	maDyama/vA/h	maDyamavA/h
maDyamaSI	maDyama/SI	maDyamaSI/
maDyamasTA	maDyama/sTA/	maDyamasTA/
maDyamasTeya	maDyama/sTe/ya	maDyamasTe/ya
mativid	mati/vi/d	mativi/d
manasketa	ma/nasketa/	manasketa/
manasmaya	ma/nasma/ya	manasma/ya
manasvin	ma/nasvin	manasvi/n
manuvat	ma/nuva/t	manuva/t
manusava	ma/nusava/	manusava/
manuzya	manuzya/	manuzya^
manuzyakilbiza	manuzya/kilbiza/	manuzyakilbiza/
manuzyakfta	manuzya/kfta	manuzya^kfta
manuzyacara	manuzya/cara/	manuzyacara/
manuzyacCandasa	manuzya/cCandasa/	manuzyacCandasa/
manuzyajA	manuzya/jA/	manuzyajA/
manuzyatrA	manuzya/trA/	manuzyatrA/
manuzyatva	manuzya/tva/	manuzyatva/
manuzyadeva	manuzya/deva/	manuzyadeva/
manuzyayajYa	manuzya/yajYa/	manuzyayajYa/
manuzyaraTa	manuzya/raTa/	manuzyaraTa/
manuzyarAja	manuzya/rAja/	manuzyarAja/
manuzyaloka	manuzya/loka/	manuzyaloka/
manuzyasava	manuzya/sava/	manuzyasava/
manojava	manojava/,ma/nojava/	manojava/,ma/nojava
mantavya	mantavya^	manta/vya
mantrakft	ma/ntrakf/t	mantrakf/t
mantraSrutya	ma/ntraSru/tya	mantraSru/tya
manyumI	manyu/mI/	manyumI/
manyuSamana	manyu/Sa/mana	manyuSa/mana
manyuzAvin	manyu/zAvi/n	manyuzAvi/n
mamasatya	ma/masatya/	mamasatya/
mayaskara	ma/yaskara/	mayaskara/
marIcipa	ma/rIcipa/	marIcipa/
marutvatIya	maru/tvatI/ya	marutvatI/ya
marutvatya	maru/tvatya	marutvatya^
marutstoma	maru/tstoma/	marutstoma/
marka	marka/	marka/,ma/rka
martaBojana	ma/rtaBo/jana	martaBo/jana
martyatrA	ma/rtyatrA/	martyatrA/
martyatvana	ma/rtyatvana/	martyatvana/
maryatas	ma/ryatas	maryata/s
malaga	ma/laga/	malaga/
maSakajamBana	maSa/kaja/mBana	maSakaja/mBana
mahatkARqa	maha/tkARqa/	mahatkARqa/
mahas	ma/has	ma/has,maha/s
mahAkula	mahA/kula,mahA/kula/	mahAkula/
mahAkulIna	mahA/kulIna	mahAkulI/na
mahAgaRa	mahA/gaRa/	mahAgaRa/
mahAgaya	mahA/gaya/	mahAgaya/
mahAgrAma	mahA/grAma/	mahAgrAma/
mahAja	mahA/ja/,mahA/ja	mahAja/
mahAjanIya	mahA/janIya	mahAjanI/ya
mahAjAtIya	mahA/jAtIya	mahAjAtI/ya
mahADana	mahA/Dana/	mahADana/
mahADura	mahA/Dura	mahADura/
mahAnagna	mahA/nagna/	mahAnagna/
mahAnAga	mahA/nAga/	mahAnAga/
mahApada	mahA/pada/	mahApada/
mahAbrahma	mahA/brahma	mahAbrahma/
mahAbrAhmaRa	mahA/brAhmaRa/	mahAbrAhmaRa/
mahAmatsya	mahA/matsya/	mahAmatsya/
mahAmaha	mahA/maha,mahA/maha/	mahAmaha/
mahAyajYa	mahA/yajYa/	mahAyajYa/
mahAyama	mahA/yama/	mahAyama/
mahArAja	mahA/rAja/	mahArAja/
mahAvIra	mahA/vIra/	mahAvIra/
mahAvfkza	mahA/vfkza/	mahAvfkza/
mahAvfza	mahA/vfza/	mahAvfza/
mahAvrata	mahA/vrata/	mahAvrata/
mahAvratIya	mahA/vratI/ya	mahAvratI/ya
mahAsattra	mahA/sattra/	mahAsattra/
mahAsuparRa	mahA/suparRa/	mahAsuparRa/
mahAsuhaya	mahA/suhaya/	mahAsuhaya/
mahAhavis	mahA/havi/s	mahAhavi/s
mahAhastin	mahA/hasti/n	mahAhasti/n
mahokza	mahokza/,maho/kza	mahokza/
mahi	ma/hi	mahi/,ma/hi
mahivfD	ma/hivf/D	mahivf/D
mahiman	ma/hima/n	mahima/n
mAMScatva	mAMScatva/	mAMScatva/,mA/MScatva
mAMsaBikzA	mAMsa/BikzA/	mAMsaBikzA/
mAtfbanDu	mAtf/banDu	mAtfbanDu/
mAtfBogIRa	mAtf/BogIRa	mAtfBogI/Ra
mAtfzvaseya	mAtf/zvaseya	mAtfzvaseya/
mAtfzvasrIya	mAtf/zvasrIya	mAtfzvasrIya/
mADyaMdina	mADya/Mdina	mA/DyaMdina
mAna	mA/na	mA/na,mAna/
mAyAvin	mAyA/vi/n	mAyAvi/n
mArjAlya	mArjAlya/	mArjAlya^
mAsaSas	mA/saSa/s	mAsaSa/s
mAhArajana	mAhArajana/	mA/hArajana
mitrakru	mitra/kru/	mitrakru/
mitratUrya	mitra/tU/rya	mitratU/rya
mitratva	mitra/tva	mitratva/
mitraDA	mitra/DA/	mitraDA/
mitraDeya	mitra/De/ya	mitraDe/ya
mitrayuj	mitra/yu/j	mitrayu/j
mitravarDana	mitra/va/rDana	mitrava/rDana
mitrya	mitrya/	mitrya^
miTastur	miTa/stu/r	miTastu/r
miTunatva	miTuna/tva/	miTunatva/
miTUdfS	mi/TUdf/S	miTUdf/S
miTyAkarman	miTyA/ka/rman	miTyAka/rman
muYjanejana	mu/Yjane/jana	muYjane/jana
muzwihatyA	muzwi/hatyA/	muzwihatyA/
muzwihan	muzwi/ha/n	muzwiha/n
muhurgir	mu/hurgi/r	muhurgi/r
mUlakft	mU/lakf/t	mUlakf/t
mUlatas	mU/lata/s	mUlata/s
mUlabarhaRa	mU/laba/rhaRa	mUlaba/rhaRa
mftyupASa	mftyu/pASa/	mftyupASa/
mftyubanDu	mftyu/ba/nDu	mftyu/banDu
mfgaSIrza	mfga/SIrza/	mfgaSIrza/
mfgasakTa	mfga/sakTa	mfgasakTa/
mfgayA	mf/gayA	mfgayA/
mfdujAtIya	mfdu/jAtIya	mfdujAtI/ya
meTizWa	meTi/zWa	meTizWa/
meDA	me/DA,meDA/	meDA/
meDapati	me/Dapati	meDa/pati
meDasAti	me/DasAti	meDa/sAti
meDAkAra	meDA/kAra/	meDAkAra/
meDAtiTi	meDA/tiTi	me/DAtiTi
meDAvin	meDA/vi/n	meDAvi/n
meDyatva	me/Dyatva/	meDyatva/
mehanA	me/hanA,meha/nA	meha/nA
mEtravarDaka	mEtra/varDaka	mE/travarDaka
yakzadfS	yakza/df/S	yakzadf/S
yakzaBft	yakza/Bf/t	yakzaBf/t
yakzmanASana	ya/kzmanA/Sana	yakzmanA/Sana
yajamAna	ya/jamAna	ya/jamAna,yajamAna/
yajamAnabrAhmaRa	ya/jamAnabrAhmaRa/	yajamAnabrAhmaRa/
yajas	ya/jas	yaja^s
yajuzya	yajuzya/	yajuzya^
yajYakft	yajYa/kf/t	yajYakf/t
yajYakratu	yajYa/kratu/	yajYakratu/
yajYatanU	yajYa/tanU/	yajYatanU/
yajYanizkft	yajYa/nizkf/t	yajYanizkf/t
yajYanI	yajYa/nI/	yajYanI/
yajYapaTa	yajYa/paTa/	yajYapaTa/
yajYaparus	yajYa/paru/s	yajYaparu/s
yajYapAtra	yajYa/pAtra/	yajYapAtra/
yajYapAtrIya	yajYa/pAtrI/ya	yajYapAtrI/ya
yajYapucCa	yajYa/pucCa/	yajYapucCa/
yajYaprI	yajYa/prI/	yajYaprI/
yajYamuKa	yajYa/muKa/	yajYamuKa/
yajYayaSasa	yajYa/yaSasa	yajYayaSasa/
yajYavacas	yajYa/vacas	yajYavaca/s,yajYa/vacas
yajYavAstu	yajYa/vAstu/	yajYavAstu/
yajYavid	yajYa/vi/d	yajYavi/d
yajYaveSasa	yajYa/veSasa/	yajYaveSasa/
yajYaSrI	yajYa/SrI/	yajYaSrI/
yajYasAD	yajYa/sA/D	yajYasA/D
yajYasADana	yajYa/sA/Dana	yajYasA/Dana
yajYahan	yajYa/ha/n	yajYaha/n
yatrakAmam	ya/trakA/mam	yatrakA/mam
yaTAkarma	ya/TAkarma/	yaTAkarma/
yaTAkAmam	ya/TAkAmam	yaTAkAma/m
yaTAkArin	ya/TAkAri/n	yaTAkAri/n
yaTAKAtam	ya/TAKAta/m	yaTAKAta/m
yaTAgfhItam	ya/TAgfhIta/m	yaTAgfhIta/m
yaTANgam	ya/TANga/m	yaTANga/m
yaTAcamasam	ya/TAcamasa/m	yaTAcamasa/m
yaTAcArin	ya/TAcAri/n	yaTAcAri/n
yaTAjAtam	ya/TAjAta/m	yaTAjAta/m
yaTAdevatam	ya/TAdevata/m	yaTAdevata/m
yaTADarmam	ya/TADarma/m	yaTADarma/m
yaTADizRyam	ya/TADizRya/m	yaTADizRya/m
yaTAnAma	ya/TAnAma,ya/TAnAma/	yaTAnAma/
yaTAparu	ya/TAparu/	yaTAparu/
yaTApratirUpam	ya/TApratirUpa/m	yaTApratirUpa/m
yaTAbalam	ya/TAbala/m	yaTAbala/m
yaTABAgam	ya/TABAga/m	yaTABAga/m
yaTABijYAyam	ya/TABijYA/yam	yaTABijYA/yam
yaTAmuKIna	ya/TAmuKIna	yaTAmuKI/na
yaTAyajus	ya/TAyaju/s	yaTAyaju/s
yaTAyatanam	ya/TAyatana/m	yaTAyatana/m
yaTAyaTam	ya/TAyaTa/m	yaTAyaTa/m
yaTArTam	ya/TArTa/m,ya/TArTam	yaTArTa/m
yaTAlokam	ya/TAloka/m	yaTAloka/m
yaTAvakASam	ya/TAvakASa/m	yaTAvakASa/m
yaTAvaSam	ya/TAvaSa/m	yaTAvaSa/m
yaTASarIram	ya/TASarIra/m	yaTASarIra/m
yaTASradDam	ya/TASradDa/m	yaTASradDa/m
yaTASrezWam	ya/TASrezWa/m	yaTASrezWa/m
yaTAsTAnam	ya/TAsTAna/m	yaTAsTAna/m
yaTAsTAma	ya/TAsTAma/	yaTAsTAma/
yaTetam	yaT'eta/m	yaTeta/m
yatkAmyA	ya/tkAmyA/	yatkAmyA/
yataMkara	yata/Mkara/	yataMkara/
yamagATA	ya/magATA/	yamagATA/
yamatva	ya/matva/	yamatva/
yamadUta	ya/madUta/	yamadUta/
yamanakzatra	ya/manakzatra/	yamanakzatra/
yamanetra	ya/manetra	yama/netra
yamarAjan	ya/marAjan,yama/rAjan	yama/rAjan
yamarAjya	ya/marA/jya	yamarA/jya
yamaSrezWa	ya/maSrezWa	yama/SrezWa
yamasAdana	ya/masAdana/	yamasAdana/
yamasU	ya/masU/	yamasU/
yamunA	yamu/nA	yamu/nA/
yamya	yamya/	ya/mya/,yamya^
yavya	yavya/,ya/vya	ya/vya,yavya/
yavamaya	ya/vama/ya	yavama/ya
yavAgUmaya	yavAgU/maya	yavAgUma/ya
yavyA	ya/vyA/	yavyA/
yaSaskft	ya/Saskf/t	yaSaskf/t
yaSasvin	ya/Sasvi/n	yaSasvi/n
yaSasya	yaSasya/	yaSasya^
yahu	ya/hu	yahu/
yAtucAtana	yAtu/cA/tana	yAtucA/tana
yAtujamBana	yAtu/jamBana	yAtuja/mBana
yAtujU	yAtu/jU/	yAtujU/
yAtuDAna	yAtu/DA/na	yAtuDA/na
yAtuvid	yAtu/vi/d	yAtuvi/d
yAtuhan	yAtu/ha/n	yAtuha/n
yAma	yA/ma,yAma/	yAma/,yA/ma
yAmakoSa	yA/makoSa/	yAmakoSa/
yAvatsabanDu	yA/vatsa/banDu	yAvatsa/banDu
yugapad	yuga/pad	yu/gapad
yugamAtra	yuga/mAtra,yuga/mAtra/	yugamAtra/
yoktavya	yoktavya^	yoktavya/
yuvadrik	yuva/dri/k	yuvadri/k
yuvaddevatya	yuvaddevatya/	yuvaddeva/tya
yuvat	yu/vat	yuva/t
yUTya	yUTya/	yUTya^
yUpavAha	yU/pavAha/	yUpavAha/
yUpavraska	yU/pavraska/	yUpavraska/
yogakzema	yo/gakzema/	yogakzema/
rakzas	ra/kzas	ra/kzas,rakza/s
rakzastva	ra/kzastva/	rakzastva/
rakzasvin	ra/kzasvi/n	rakzasvi/n
rakzasya	rakzasya/	rakzasya^
raGuja	raGu/ja/	raGuja/
raGudru	raGu/dru/	raGudru/
raGupatmajaMhas	raGu/pa/tmajaMhas	raGupa/tmajaMhas
raGupatvan	raGu/pa/tvan	raGupa/tvan
raGuyAman	raGu/yA/man	raGuyA/man
raGuzyad	raGu/zya/d	raGuzya/d
raji	raji/,ra/ji	raji/
rajjusarja	ra/jjusarja/	rajjusarja/
rajjavya	rajjavya/	rajjavya^
rajatapAtra	rajata/pAtra/	rajatapAtra/
rajastur	ra/jastu/r	rajastu/r
rajasvala	ra/jasvala	rajasvala/
rajasya	rajasya/	rajasya^
raRakft	ra/Rakf/t	raRakf/t
raRya	ra/Rya	ra/Rya,raRya^
raRyajit	ra/Ryaji/t	raRyaji/t
raRyavAc	ra/RyavA/c	raRyavA/c
ratnaDA	ra/tnaDA/	ratnaDA/
ratnaDeya	ra/tnaDe/ya	ratnaDe/ya
ratnaBAj	ra/tnaBA/j	ratnaBA/j
raTI	ra/TI,raTI/	raTI/
raTakawyA	ra/TakawyA	raTakawyA/
raTakAra	ra/TakAra/	raTakAra/
raTakrIta	ra/TakrIta/	raTakrIta/
raTagftsa	ra/Tagftsa/	raTagftsa/
raTacakra	ra/Tacakra/	raTacakra/
raTacarzaRa	ra/Taca/rzaRa	raTaca/rzaRa
raTajit	ra/Taji/t,raTaji/t	raTaji/t
raTanABi	ra/TanABi/	raTanABi/
raTaMtara	ra/TaMtara/	raTaMtara/
raTaprA	ra/TaprA/	raTaprA/
raTamuKa	ra/TamuKa/	raTamuKa/
raTayAna	ra/TayA/na	raTayA/na
raTayAvan	ra/TayA/van	raTayA/van
raTayuj	ra/Tayu/j	raTayu/j
raTavartman	ra/Tavartman	raTavartma/n
raTavAha	ra/TavAha/	raTavAha/
raTaSIrza	ra/TaSIrza	raTaSIrza/
raTaSreRi	ra/TaSreRi/	raTaSreRi/
raTasaNga	ra/TasaNga/	raTasaNga/
raTaspfS	ra/Taspf/S	raTaspf/S
raTasvana	ra/Tasvana	raTasvana/
raDracoda	raDra/coda/	raDracoda/
raDracodana	raDra/codana/	raDraco/dana
ranDi	ra/nDi	ranDi/
ramati	rama/ti,ra/ma/ti	rama/ti,ra/mati
ramya	ramya/	ramya^
rayida	rayi/da/	rayida/
rayipati	rayi/pa/ti	rayipa/ti
rayivid	rayi/vi/d	rayivi/d
rayivfD	rayi/vf/D	rayivf/D
rayizWA	rayi/zWA/	rayizWA/
rayisTAna	rayi/sTA/na	rayisTA/na
rasaGana	ra/saGana/	rasaGana/
rasantama	ra/santama/	rasantama/
rAtizAc	rAti/zA/c	rAtizA/c
rAjaka	rAjaka/	rAjaka/,rA/jaka
rAjan	rAja/n	rA/jan,rAja/n
rAjanya	rAjanya^,rAjanya/	rAjanya^
rAjanyabanDu	rAjanya/banDu	rAjanya^banDu
rAtriMdiva	rA/triMdiva	rAtriMdiva/
rAtrizAman	rA/trizAman	rAtrizAma/n
rATaMtarAyaRa	rA/TaMtarAyaRa	rATaMtarAyaRa/
rAmyA	rA/myA	rAmyA/
rAzwradA	rAzwra/dA/	rAzwradA/
rAzwradipsu	rAzwra/dipsu/	rAzwradipsu/
rAzwraBft	rAzwra/Bf/t	rAzwraBf/t
rAzwraBfti	rAzwra/Bf/ti	rAzwraBf/ti
rAzwraBftya	rAzwra/Bf/tya	rAzwraBf/tya
riktakumBa	rikta/kumBa/	riktakumBa/
riktaguru	rikta/guru	ri/ktaguru
ripravAha	ripra/vAha/	ripravAha/
rItyap	rItya/p	rItya^p
rukmapASa	rukma/pASa/	rukmapASa/
ruDira	ruDira/,ru/Dira/	ruDira/
rUpakft	rUpa/kf/t	rUpakf/t
rUpaDeya	rUpa/De/ya	rUpaDe/ya
retasvin	re/tasvi/n	retasvi/n
revatya	revatya/	revatya^
roganASana	ro/ganA/Sana	roganA/Sana
rocanasTA	rocana/sTA/	rocanasTA/
rodastva	ro/dastva/	rodastva/
rohiRItva	ro/hiRItva/	rohiRItva/
rOdra	rO/dra	rOdra/
lakzmaRya	lakzmaRya/	lakzmaRya^
lokakft	loka/kft	lokakf/t
lokakftnu	loka/kftnu/	lokakftnu/
lokajit	loka/ji/t	lokaji/t
lokapAla	loka/pAla/	lokapAla/
lokaBAj	loka/BA/j	lokaBA/j
lokamaya	loka/ma/ya	lokama/ya
lokasani	loka/sa/ni	lokasa/ni
lokaspft	loka/spf/t	lokaspf/t
lokya	lokya/	lokya^
lomaSasakTa	lomaSa/sakTa	lomaSasa/kTa
lohamaya	loha/ma/ya	lohama/ya
vaMSanartin	vaMSa/narti/n	vaMSanarti/n
vakzaRA	va/kza/RA,va/kzaRA	vakza/RA
vaktavya	vaktavya^	vakta/vya
vacasya	vacasya/	vacasya^,vacasya/
vajraBft	va/jraBft	vajraBf/t
vajravah	va/jrava/h	vajrava/h
vatsatara	vatsa/tara/	vatsatara/
vatsaprI	vatsa/prI/	vatsaprI/
vaDatra	vaDatra/,va/Datra	va/Datra
vaDrimatI	va/DrimatI/	vaDrimatI/
vaDUdarSa	vaDU/darSa/	vaDUdarSa/
vaDUpaTa	vaDU/paTa/	vaDUpaTa/
vanakrakza	va/nakrakza/	vanakrakza/
vanaMkaraRa	va/naMka/raRa	vanaMkara/Ra
vanaDiti	va/naDiti	vana/Diti
vanapa	va/napa/	vanapa/
vanaprakza	va/naprakza/	vanaprakza/
vanasad	va/nasa/d	vanasa/d
vanaspati	vanaspa/ti,va/naspa/ti	va/naspa/ti
vapuzya	vapuzya/	vapuzya^
vayaskft	va/yaskf/t	vayaskf/t
vayunaSas	vayu/naSa/s	vayunaSa/s
vayya	vayya/	vayya^
varasad	va/rasa/d	varasa/d
variman	varima/n	varima/n,va/riman
varivaskft	va/rivaskf/t	varivaskf/t
varuRaDrut	va/ruRaDru/t	varuRaDru/t
varuRapASa	va/ruRapASa/	varuRapASa/
varuRapraGAsa	va/ruRapraGAsa/	varuRapraGAsa/
varuRameni	va/ruRameni/	varuRameni/
varuRasava	va/ruRasava/	varuRasava/
varuRya	varuRya/	varuRya^
varUTya	varUTya/	varUTya^
varAhu	varAhu/	varA/hu
varcasvin	va/rcasvi/n	varcasvi/n
varcasya	varcasya/	varcasya^
varzman	varzma/n	varzma/n,va/rzman
valaMruja	vala/Mruja/	valaMruja/
valaga	vala/ga/	valaga/
valagahan	vala/ga/ha/n	valagaha/n
valagin	vala/gi/n	valagi/n
vaSA	va/SA,vaSA/	vaSA/
vaSanI	va/SanI/	vaSanI/
vazawkAra	va/zawkAra/	vazawkAra/
vasavya	vasavya/	vasavya^
vasA	va/sA,vasA/	va/sA
vasujit	va/suji/t	vasuji/t
vasutA	va/sutA	vasu/tA
vasutAti	va/sutAti	vasu/tAti
vasutva	va/sutva/	vasutva/
vasutvana	va/sutvana/	vasutvana/
vasudA	va/sudA,va/sudA/	vasu/dA
vasudAna	va/sudA/na	vasudA/na
vasudAvan	va/sudA/van	vasudA/van
vasudeya	va/sude/ya	vasude/ya
vasuDAna	va/suDA/na	vasuDA/na
vasuDeya	va/suDe/ya	vasuDe/ya
vasupatnI	va/supa/tnI	vasupa/tnI
vasumaya	va/suma/ya	vasuma/ya
vasuruc	va/suru/c	vasuru/c
vasuvan	va/suva/n	vasuva/n
vasuvani	va/suva/ni	vasuva/ni
vasuvid	va/suvi/d	vasuvi/d
vastibila	vasti/bila/	vastibila/
vahyaSIvan	vahya/SI/van	vahyaSI/van
vAtajUta	vAtajUta/	vA/tajUta
vAtApya	vA/tApya	vAtA/pya
vAkovAkya	vAkovAkya/	vAkovAkya^
vAjakftya	vA/jakf/tya	vAjakf/tya
vAjajit	vA/jaji/t	vAjaji/t
vAjajityA	vA/jajityA/	vAjajityA/
vAjadA	vA/jadA/	vAjadA/
vAjadAvan	vA/jadA/van	vAjadA/van
vAjapeya	vA/jape/ya	vAjape/ya
vAjaprasavIya	vA/japrasavI/ya	vAjaprasavI/ya
vAjasani	vA/jasa/ni	vAjasa/ni
vAjasaneya	vA/jasaneya,vAjasaneya/	vAjasaneya/
vAjasA	vA/jasA/	vAjasA/
vAjasft	vA/jasf/t	vAjasf/t
vAtsIputra	vAtsI/pu/tra	vA/tsIpu/tra
vAtsImARqavIputra	vAtsImARqavIpu/tra	vA/tsImARqavIpu/tra
vAnyA	vAnyA/	vAnyA^
vAmadevya	vAma/devya/	vAmadevya/
vAmaBAj	vAma/BA/j	vAmaBA/j
vAmaBft	vAma/Bf/t	vAmaBf/t
vAmamoza	vAma/moza/	vAmamoza/
vAmaraTya	vAma/raTya	vAmaraTya/
vAyudatteya	vAyu/datteya	vA/yudatteya,vAyudatteya/
vAyumaya	vAyu/maya	vAyuma/ya
vAyavya	vAyavya/	vAyavya^
vAravantIya	vA/ravantI/ya	vAravantI/ya
vArzagaRIputra	vArzagaRIpu/tra	vA/rzagaRIpu/tra
vAlaDAna	vA/laDA/na	vAlaDA/na
vAsava	vAsava/	vA/sava
vAsavadattika	vAsava/dattika	vAsavadattika/
vAsavadatteya	vAsava/datteya	vAsavadatteya/
vAstupa	vA/stupa/	vAstupa/
vAstuvidya	vA/stuvidya	vAstuvidya/
vAhasa	vAhasa/	vA/hasa
virAj	vi/rAj,virA/j	virA/j
vikaNkawika	vi/kaNkawika	vikaNkawika/
vikaNkatImuKa	vi/kaNkatImuKa	vikaNkatI/muKa
vikawa	vi/kawa	vikawa/
vikarRa	vi/karRa/	vikarRa/
vikeSa	vi/keSa/	vikeSa/
vikrama	vi/krama,vikrama/	vikrama/
vigada	vi/gada,vigada/	vigada/
viGana	vi/Gana,viGana/	viGana/
vicatura	vi/catura	vicatura/
vijara	vi/jara/	vijara/
vijAni	vi/jAni	vijA/ni
vijAman	vi/jAman,vijA/man	vijA/man
vijiGatsa	vi/jiGatsa/	vijiGatsa/
vijenya	vi/jenya/	vijenya^
vitaram	vi/taram,vitara/m	vitara/m
vitftIya	vi/tftIya/	vitftIya/
videGa	vi/deGa/	videGa/
videva	vi/deva,videva/	vi/deva
videha	vi/deha	videha/
vidoha	vi/doha/,vidoha/	vidoha/
vidyut	vi/dyut,vidyu/t	vidyu/t
vipaTa	vi/paTa,vipaTa/	vipaTa/
vipApa	vi/pApa/	vipApa/
vipurIza	vi/purIza/	vipurIza/
viboDa	vi/boDa	viboDa/
viBItaka	vi/BItaka,viBI/taka	viBI/taka
vimatiman	vi/matiman	vimatima/n
vimada	vi/mada,vi/mada/	vimada/
vimaniman	vi/maniman	vimanima/n
vimAna	vi/mAna	vimA/na
vilohita	vi/lohita/,vi/lohita	vilohita/,vi/lohita
vivaruRa	vi/varuRa/	vivaruRa/
viSaPa	vi/SaPa/	viSaPa/
viSiKa	vi/SiKa/	viSiKa/
viSuzka	vi/Suzka	viSuzka/
viSravas	vi/Sra/vas	vi/Sravas
vizkanDadUzaRa	vi/zkanDadU/zaRa	vizkanDadU/zaRa
visalya	vi/salya/	visa/lya
visukft	vi/sukf/t	visukf/t
visoma	vi/soma/	visoma/
vikrAma	vi/krAma/	vikrAma/
vicakzas	vica/kzas	vi/cakzas
vigra	vi/gra	vigra/
vijYAnamaya	vijYA/nama/ya	vijYAnama/ya
vitarturam	vi/tartura/m	vitartura/m
vidaTya	vida/Tya/	vidaTya^
vittakAmyA	vitta/kAmyA/	vittakAmyA/
vittaDa	vitta/Da/	vittaDa/
vidAna	vi/dAna	vidA/na
videSya	videSya/	videSya^
vidyutya	vidyutya/	vidyutya^
viDAra	vi/DA/ra	viDA/ra
viDAraya	vi/DAraya/	viDAraya/
viprarAjya	vi/prarA/jya	viprarA/jya
viBukratu	viBu/kra/tu	viBukra/tu
viBUdAvan	viBUdA/van	viBU/dAvan
viBvan	vi/Bvan,vi/Bva/n	vi/Bvan,viBva/n
viBftvan	vi/Bf/tvan	viBf/tvan
virADana	virA/Dana	vi/rADana
vivAcana	vi/vA/cana	vivA/cana
viSpati	vi/Spa/ti,viSpa/ti	viSpa/ti
viSpatnI	vi/Spa/tnI	viSpa/tnI
viSya	viSya/	viSya^
viSvakarma	vi/Svakarma,viSva/karma	viSva/karma
viSvakarman	vi/Svakarman,viSva/karman	viSva/karman
viSvakft	vi/Svakf/t	viSvakf/t
viSvakfzwi	vi/Svakfzwi	viSva/kfzwi
viSvakziti	vi/Svakziti	viSva/kziti
viSvagarBa	vi/SvagarBa	viSva/garBa
viSvagUrta	vi/SvagUrta	viSva/gUrta
viSvagotra	vi/Svagotra	viSva/gotra
viSvagotrya	vi/Svagotrya	viSva/gotrya
viSvacakzaRa	vi/SvacakzaRa	viSva/cakzaRa
viSvacakzas	vi/Svacakzas	viSva/cakzas
viSvacarzaRi	vi/SvacarzaRi	viSva/carzaRi
viSvajana	vi/Svajana/	viSvajana/
viSvajanIna	vi/SvajanI/na	viSvajanI/na
viSvajanIya	vi/SvajanIya	viSvajanI/ya
viSvajanman	vi/Svajanman	viSva/janman
viSvajanya	vi/Svajanya	viSva/janya
viSvajit	vi/Svaji/t	viSvaji/t
viSvajU	vi/SvajU/	viSvajU/
viSvatas	vi/Svatas,viSva/tas	viSva/tas
viSvatur	vi/Svatu/r	viSvatu/r
viSvatUrti	vi/SvatUrti	viSva/tUrti
viSvadAni	vi/SvadA/ni	viSvadA/ni
viSvadAva	vi/SvadAva/	viSvadAva/
viSvadAvya	vi/SvadAvya/	viSvadAvya^
viSvadfzwa	vi/Svadfzwa	viSva/dfzwa
viSvadeva	vi/Svadeva	viSva/deva
viSvadevanetra	vi/Svadevanetra	viSva/devanetra
viSvadohas	vi/Svadohas	viSva/dohas
viSvaDAyas	vi/SvaDAyas	viSva/DAyas
viSvaDena	vi/SvaDena	viSva/Dena
viSvanAman	vi/SvanAman	viSva/nAman
viSvapiS	vi/Svapi/S	viSvapi/S
viSvapuz	vi/Svapu/z	viSvapu/z
viSvapeSas	vi/SvapeSas	viSva/peSas
viSvaprI	vi/SvaprI/	viSvaprI/
viSvapsan	vi/Svapsan	viSvapsa/n
viSvapsu	vi/Svapsu	viSva/psu
viSvaBaras	vi/SvaBaras	viSvaBa/ras
viSvaBAnu	vi/SvaBAnu	viSva/BAnu
viSvaBft	vi/SvaBf/t	viSvaBf/t
viSvaBojas	vi/SvaBojas	viSva/Bojas
viSvamanus	vi/Svamanus	viSva/manus
viSvamahas	vi/Svamahas	viSva/mahas
viSvaminva	vi/Svaminva/	viSvaminva/
viSvayaSas	vi/SvayaSas	viSva/yaSas
viSvarADas	vi/SvarADas	viSva/rADas
viSvarUpa	vi/SvarUpa,viSva/rUpa	viSva/rUpa
viSvavani	vi/Svava/ni	viSvava/ni
viSvavAra	vi/SvavAra	viSva/vAra
viSvavArya	vi/SvavArya	viSva/vArya
viSvavid	vi/Svavi/d	viSvavi/d
viSvaSArada	vi/SvaSArada	viSva/SArada
viSvaSuc	vi/SvaSu/c	viSvaSu/c
viSvaScandra	vi/SvaScandra	viSva/Scandra
viSvasuvid	vi/Svasuvi/d	viSvasuvi/d
viSvasU	vi/SvasU/	viSvasU/
viSvasOBaga	vi/SvasOBaga	viSva/sOBaga
viSvANgya	viSvANgya/	viSvANgya^
viSvataspad	viSva/taspad	viSvataspa/d
viza	vi/za,vi/za/	vi/za,viza/
vizA	vi/zA	vizA/
vizagiri	vi/zagiri/	vizagiri/
vizadUzaRa	vi/zadU/zaRa	vizadU/zaRa
vizaDAna	vi/zaDA/na	vizaDA/na
vizWAvrAjin	vizWA/vrAji/n	vizWAvrAji/n
vizRukrama	vi/zRukrama/	vizRukrama/
vIti	vIti/	vI/ti
vIci	vI/ci	vI/ci,vIci/
vIRAgATin	vI/RAgATi/n	vIRAgATi/n
vIRAvAda	vI/RAvAda/	vIRAvAda/
vIrakarma	vIra/ka/rma	vIraka/rma
vIraGnI	vIra/GnI	vIraGnI/
vIravah	vIra/va/h	vIrava/h
vIravid	vIra/vi/d	vIravi/d
vIrasU	vIra/sU	vIrasU/
vIrahan	vIra/ha/n	vIraha/n
vIrya	vIrya/	vIrya^
vIryakft	vIrya/kf/t	vIryakf/t
vftraKAda	vftra/KAda/	vftraKAda/
vftratara	vftra/ta/ra	vftrata/ra
vftratur	vftra/tur	vftratu/r
vftratUrya	vftra/tU/rya	vftratU/rya
vftratva	vftra/tva/	vftratva/
vftraSaNku	vftra/SaNku/	vftraSaNku/
vftraha	vftra/ha/	vftraha/
vftrahan	vftra/ha/n	vftraha/n
vfTAzah	vf/TAza/h	vfTAza/h
vfkatAt	vf/katAt	vfka/tAt
vfkzaKaRqa	vfkza/KaRqa	vfkzaKa/Rqa
vfkzya	vfkzya/	vfkzya^
vfjana	vfja/na	vfja/na,vf/jana
vfjanya	vfjanya/	vfjanya^
vfSa	vf/Sa	vfSa/
vfzwikAma	vfzwi/kAma	vf/zwikAma
vfzwivani	vfzwi/va/ni	vfzwiva/ni
vfzwisani	vfzwi/sa/ni	vfzwisa/ni
vfzwihavya	vfzwi/ha/vya	vfzwiha/vya
veditavya	veditavya^	vedita/vya
veda	veda/	ve/da,veda/
vedizad	ve/diza/d	vediza/d
vEdeha	vEdeha/,vE/deha/	vE/deha
vEzRavavAruRa	vEzRava/vAruRa	vEzRavavAruRa/
vEzRavya	vEzRavya/	vEzRavya^
vyaMsa	vya/Msa	vya^Msa
vyaDvan	vya/Dvan	vya^Dvan
vyanta	vya/nta	vya^nta
vyalkaSa	vya/lkaSa	vya^lkaSa
vyaSva	vya/Sva	vya^Sva
vyenas	vye/nas	vye^nas
vyenI	vye/nI	vye/nI,vye^nI
vyElaba	vyE/laba	vyE^laba
vyokas	vyo/kas	vyo^kas
vyaNga	vya/Nga	vya^Nga
vyaTA	vyaTA/	vya/TA
vyazwi	vya/zwi	vya^zwi
vyAGrajamBana	vyAGra/ja/mBana	vyAGraja/mBana
vyAGraloman	vyAGra/loma/n	vyAGraloma/n
vyADI	vyA/DI	vyA^DI
vyApti	vyA/pti	vyA^pti
vyAmya	vyAmya/	vyAmya^
vyuptakeSa	vyu/ptakeSa	vyu^ptakeSa
vyuzwi	vyu/zwi	vyu^zwi
vyUQa	vyU/Qa	vyU^Qa
vrajakzit	vraja/kzi/t	vrajakzi/t
vrAjapati	vrAja/pati/	vrAja/pati
vratacaryA	vrata/caryA/	vratacaryA/
vratacArin	vrata/cAri/n	vratacAri/n
vrataduGA	vrata/du/GA	vratadu/GA
vratanI	vrata/nI/	vratanI/
vratapA	vrata/pA/	vratapA/
vrataprada	vrata/prada/	vrataprada/
vrataBft	vrata/Bf/t	vrataBf/t
vratya	vratya/	vratya^,vra/tya
vrAtasAha	vrA/tasAha	vrAtasAha/
vrAtyabruva	vrA/tyabruva/	vrAtyabruva/
vrIhimaya	vrIhi/ma/ya	vrIhima/ya
Sastra	Sastra/,Sa/stra	Sastra/
SakaDUma	Sa/kaDU/ma	SakaDU/ma
SakapiRqa	Sa/kapiRqa	SakapiRqa/
Sakamaya	Sa/kama/ya	Sakama/ya
SakunisAda	Saku/nisAda/	SakunisAda/
Sakunta	Sa/ku/nta	Saku/nta
SaNKaDma	SaNKa/Dma/	SaNKaDma/
SaNKapuzpI	SaNKa/puzpI	SaNKapuzpI/
SaNKaBinna	SaNKa/Binna	SaNKaBinna/
Satagvin	Sata/gvi/n	Satagvi/n
Satacakra	Sata/cakra	Sataca/kra
Satatama	Sata/tama/	Satatama/
Satatarha	Sata/tarha/	Satatarha/
SatadAvan	Sata/dA/van	SatadA/van
Satadru	Sata/dru	Satadru/
SataDA	Sata/DA,Sata/DA/	SataDA/
SatapaTika	Sata/paTika	Sa/tapaTika
Satapad	Sata/pad	Satapa/d,Sata/pad
SatayAjam	Sata/yA/jam	SatayA/jam
Satarudriya	Sata/rudriya	Satarudri/ya
SatarudrIya	Sata/rudrI/ya	SatarudrI/ya
SatavAhI	Sata/vAhI/	SatavAhI/
SataSas	Sata/Sa/s	SataSa/s
SataSAKa	Sata/SAKa	SataSA/Ka
SatasA	Sata/sA/	SatasA/
Sataseya	Sata/se/ya	Satase/ya
Satasvin	Sata/svi/n	Satasvi/n
Satahan	Sata/ha/n	Sataha/n
SatAtfRRa	SatA/tfRRa	SatAtfRRa/
SatrutUrya	Sa/trutU/rya	SatrutU/rya
Satrutva	Sa/trutva/	Satrutva/
SatrubADana	Sa/trubA/Dana	SatrubA/Dana
Satruvala	Sa/truvala	Satruvala/
Satruha	Sa/truha/	Satruha/
Satruhan	Sa/truha/n	Satruha/n
SapaTeyya	SapaTeyya/	SapaTeyya^
SapaTya	SapaTya/	SapaTya^
Sapanatara	Sa/panatara	Sapana/tara
SamI	Sa/mI	Sa/mI,SamI/
SamIkuRa	Sa/mIkuRa	SamI/kuRa
SamIgarBa	Sa/mIgarBa/	SamIgarBa/
SamIDAnya	Sa/mIDAnya	SamIDAnya/
SamImaya	Sa/mIma/ya	SamIma/ya
SaMyvanta	SaMyva/nta	SaMyva^nta
SaMtanutva	Sa/Mtanutva/	SaMtanutva/
Sambarahatya	Sa/mbaraha/tya	Sambaraha/tya
Saramaya	Sara/ma/ya	Sarama/ya
Saryahan	Sa/ryaha/n	Saryaha/n
SAkina	SAkina/	SAkina/,SA/kina
SAkala	SA/kala	SAkala/
SAmulya	SAmulya/	SAmulya^
SArikukza	SA/rikukza	SArikukza/
SAriSAkA	SA/riSAkA	SAriSA/kA
SAlamaya	SAla/maya	SAlama/ya
SAlAvata	SA/lAvata	SAlAvata/
Sikya	Sikya/	Sikya^
SiKAvala	Si/KAvala	SiKAvala/
Sigru	Sigru/	Si/gru
Sipi	Sipi/	Si/pi
Sipivizwaka	Sipi/vizwaka/	Sipivizwaka/
Simyu	Si/myu	Simyu/
Silpa	Si/lpa,Silpa/	Silpa/,Si/lpa
Sivadattapura	Siva/dattapura	Sivadatta/pura
Sivapura	Siva/pura	Sivapura/
SiSumAra	Si/SumA/ra	SiSumA/ra
SIrzakapAla	SIrza/kapAla/	SIrzakapAla/
SIrzacCedya	SIrza/cCedya	SIrzacCedya^
SIrzatas	SIrza/ta/s	SIrzata/s
SIrzaBArika	SIrza/BArika	SI/rzaBArika
SIrzaBidya	SIrza/Bidya	SIrzaBi/dya
SIrzaSoka	SIrza/Soka	SIrzaSoka/
SIrzahArya	SIrza/hArya/	SIrzahArya^
SIrzaRya	SIrzaRya/	SIrzaRya^
SukraduGa	Sukra/du/Ga	Sukradu/Ga
Sukrapa	Sukra/pa/	Sukrapa/
SukrapiS	Sukra/pi/S	Sukrapi/S
Sucitva	Su/citva/	Sucitva/
SucipA	Su/cipA/	SucipA/
Sucizad	Su/ciza/d	Suciza/d
SunAsIrIya	Su/nAsI/rI/ya	SunAsIrI/ya
SuzkakaRWa	Su/zkakaRWa/	SuzkakaRWa/
Suzkadfti	Su/zkadfti/	Suzkadfti/
SuzRahatya	Su/zRaha/tya	SuzRaha/tya
Suzmada	Su/zmada/	Suzmada/
SUna	SU/na	SUna/,SU/na
SUrpaRAyIya	SU/rpaRAyIya	SUrpaRAyI/ya
SUzya	SUzya/	SUzya^
Sftatva	Sfta/tva/	Sftatva/
SftapA	Sfta/pA/	SftapA/
SftapAka	Sfta/pA/ka	SftapA/ka
SftAtaNkya	SftAtaNkya/	SftAtaNkya^
SftaMkftya	Sfta/Mkftya	SftaMkf/tya
SepaharzaRa	Se/paha/rzaRa	Sepaha/rzaRa
SevaDi	Se/vaDi/	SevaDi/
SevaDipA	Se/vaDi/pA/	SevaDipA/
Sokatara	Soka/tara/	Sokatara/
SyAvanAyIya	SyAva/nAyIya	SyAvanAyI/ya
SyAvanAyya	SyAva/nAyya	SyAvanAyya/
SyAvaputrya	SyAva/putrya	SyAvaputrya/
SyAvaraTya	SyAva/raTya	SyAvaraTya/
SyAvyA	SyAvyA/	SyAvyA^
Syenacit	Syena/ci/t	Syenaci/t
Syenapattra	Syena/pattra/	Syenapattra/
SradDAmanasyA	SradDA/manasyA/	SradDAmanasyA/
SrAntasad	SrAnta/sa/d	SrAntasa/d
Srava	Srava/	Sra/va
Sravasya	Sravasya/	Sravasya^
Srutavid	Sruta/vi/d	Srutavi/d
Srutasad	Sruta/sa/d	Srutasa/d
Sruzwi	Sruzwi/,Sru/zwi	Sruzwi/
Sruzwigu	Sruzwi/gu	Sru/zwigu
SroRitas	Sro/Rita/s	SroRita/s
SroRipratodin	Sro/Ripratodi/n	SroRipratodi/n
Srotratas	Sro/trata/s	Srotrata/s
SrotrapA	Sro/trapA/	SrotrapA/
SrotraBft	Sro/traBf/t	SrotraBf/t
Srotramaya	Sro/trama/ya	Srotrama/ya
Srotrasvin	Sro/trasvi/n	Srotrasvi/n
Slokakft	Slo/kakf/t	Slokakf/t
SloRya	Slo/Rya	SloRya^
SvAtraBAj	SvAtra/BA/j	SvAtraBA/j
zazwitama	zazwi/tama	za/zwitama
zazwipaTika	zazwi/paTika	za/zwipaTika
saMyAjya	saMyAjya/	saMyAjya^
saMvatsarasahasra	saMvatsara/sahasra/	saMvatsarasahasra/
saMvaditavya	saMvaditavya^	saMvadita/vya
saMveSya	saMveSya/	saMveSya^
saMSravas	saMSra/vas,sa/MSra/vas	saMSra/vas,sa/MSravas
saMsarpa	saMsa/rpa	saMsarpa/
saMsTitayajus	sa/MsTitayaju/s	saMsTitayaju/s
saMsrAvya	saMsrAvya/	saMsrAvya^
saMhita	sa/Mhita,sa/Mhita/	sa/Mhita
sakftsU	sakf/tsU/	sakftsU/
saMgrAmajit	saMgrAma/ji/t	saMgrAmaji/t
saKI	sa/KI	saKI/
saKitva	sa/Kitva/	saKitva/
saKitvana	sa/Kitvana/	saKitvana/
saKivid	sa/Kivi/d	saKivi/d
sacaTya	sacaTya/	sacaTya^
sacABU	sa/cABU/	sacABU/
sacivid	sa/civi/d	sacivi/d
sajAtavanasyA	sajAta/vanasyA/	sajAtavanasyA/
sajAtavani	sajAta/va/ni	sajAtava/ni
sajAtya	sajAtya/	sajAtya^
saktuSrI	sa/ktuSrI/	saktuSrI/
sattva	sa/ttva/,sattva/	sattva/
satyajit	satya/ji/t	satyaji/t
satyatA	satya/tA/	satya/tA
satyaDvft	satya/Dvf/t	satyaDvf/t
satyayaj	satya/ya/j	satyaya/j
satyavAc	satya/vA/c	satyavA/c
satyavAdin	satya/vAdi/n	satyavAdi/n
satyavfD	satya/vf/D	satyavf/D
satyasah	satya/sa/h	satyasa/h
satrAkara	satrA/kara/	satrAkara/
satrAjit	satrA/ji/t	satrAji/t
satrAsAha	satrA/sAha/	satrAsAha/
satrAha	satrA/ha/	satrAha/
satrAhan	satrA/ha/n	satrAha/n
sattrarAj	sattra/rA/j	sattrarA/j
sattrasad	sattra/sa/d	sattrasa/d
sattrasadya	sattra/sa/dya	sattrasa/dya
sattrya	sattrya/	sattrya^
sadasya	sadasya/	sadasya^
sadman	sadma/n,sa/dma/n	sadma/n,sa/dman
sAdanaspfS	sA/danaspf/S	sAdanaspf/S
sAdanya	sAdanya/	sAdanya^
sadAnIrA	sa/dAnIrA/	sadAnIrA/
sadAnvA	sa/dA/nvA	sadA/nvA
sadApfRa	sa/dApfRa/	sadApfRa/
sadAvfDa	sa/dAvfDa	sadA/vfDa
sadAsah	sa/dAsa/h	sadAsa/h
sadAsA	sa/dAsA/	sadAsA/
saDamAdya	saDamAdya/	saDamAdya^
saDrIcIna	saDrIcI/na	saDrIcIna/
saDryaYc	saDrya/Yc	saDrya^Yc
sanajA	sa/najA/	sanajA/
sanAjur	sa/nAjur	sanAju/r
sanemi	sa/nemi	sa/nemi,sane/mi
saMtatihoma	sa/Mtatihoma/	saMtatihoma/
saMdeSya	saMdeSya/	saMdeSya^
saMDAna	saMDA/na	saMDAna/
saparya	saparya/	saparya^
sapraTas	sa/praTas	sapra/Tas
sapatnakarSana	sapa/tnaka/rSana	sapatnaka/rSana
sapatnakzayaRa	sapa/tnakza/yaRa	sapatnakza/yaRa
sapatnakzit	sapa/tnakzi/t	sapatnakzi/t
sapatnacAtana	sapa/tnacA/tana	sapatnacA/tana
sapatnatur	sapa/tnatu/r	sapatnatu/r
sapatnadamBana	sapa/tnada/mBana	sapatnada/mBana
sapatnasAha	sapa/tnasAha/	sapatnasAha/
sapatnahan	sapa/tnaha/n	sapatnaha/n
saptadaSaDA	sapta/daSaDA/	saptadaSaDA/
saptarzi	saptarzi/	sapta/rzi
sabva	sabva/	sabva^
saBAga	saBA/ga/	saBAga/
saBAcara	saBA/cara/	saBAcara/
saBApati	saBA/pa/ti	saBA/pati
saBApAla	saBA/pAla	saBApAla/
saBAvin	saBA/vi/n	saBAvi/n
saBAsad	saBA/sa/d	saBAsa/d
saBAsAha	saBA/sAha/	saBAsAha/
saBAsTARu	saBA/sTARu/	saBAsTARu/
samA	samA/,sa/mA	sa/mA
samaBAga	sama/BAga	samaBAga/
samamaya	sama/maya	samama/ya
samarUpya	sama/rUpya	samarU/pya
samagra	sa/magra	samagra/
samaja	sa/maja	samaja/
samajyA	sa/majyA	samajyA/
samanaga	sa/managa/	samanaga/
samarya	samarya/	samarya/,samarya^
samavattaDAna	sama/vattaDAna	samavattaDA/na
samAnagrAmIya	samAna/grAmIya	samAnagrAmI/ya
samApya	samApya/	samApya^
samAmya	samAmya/	samAmya^
samitiMgama	sa/mitiMgama	samiti/Mgama
samuhyapurIza	samuhya/purIza	samuhya^purIza
samUhya	samUhya/	sa/mUhya
samoham	samo/ham	sa/moham
samaryajit	samarya/jit	samaryaji/t
samaryarAjya	samarya/rA/jya	samaryarA/jya
samIca	samI/ca	samIca/
sayonitva	sa/yonitva/	sayonitva/
sarasya	sarasya/	sarasya^
sarpanAma	sarpa/nAma/	sarpanAma/
sarparAjYI	sarpa/rAjYI/	sarparAjYI/
sarpavid	sarpa/vid	sarpavi/d
sarpavidyA	sarpa/vidyA/	sarpavidyA/
sarpaSIrza	sarpa/SIrza	sarpaSIrza/
sarvakfzRa	sa/rvakfzRa	sarva/kfzRa
sarvakeSaka	sa/rvakeSaka/	sarvakeSaka/
sarvagAyatra	sa/rvagAyatra	sarva/gAyatra
sarvagfhya	sa/rvagfhya/	sarvagfhya/
sarvajanIna	sa/rvajanIna	sarvajanI/na
sarvajanIya	sa/rvajanIya	sarvajanI/ya
sarvajanman	sa/rvajanman	sarva/janman
sarvajyAni	sa/rvajyAni/	sarvajyAni/
sarvatara	sa/rvatara	sarva/tara
sarvatas	sa/rvatas,sarva/tas	sarva/tas
sarvatva	sa/rvatva/	sarvatva/
sarvaTA	sa/rvaTA,sarva/TA	sarva/TA
sarvadA	sa/rvadA,sarvadA/	sarvadA/
sarvadevatya	sa/rvadevatya/	sarvadevatya^
sarvaDA	sa/rvaDA/	sarvaDA/
sarvaDurIRa	sa/rvaDurIRa	sarvaDurI/Ra
sarvapattrIRa	sa/rvapattrIRa	sarvapattrI/Ra
sarvapaTIna	sa/rvapaTIna	sarvapaTI/na
sarvapaSu	sa/rvapaSu,sarva/paSu	sarva/paSu
sarvapAYcAlaka	sa/rvapAYcAlaka	sarva/pAYcAlaka
sarvapAtrIRa	sa/rvapAtrIRa	sarvapAtrI/Ra
sarvaprAyaScitta	sa/rvaprAyaScitta/	sarvaprAyaScitta/
sarvamaya	sa/rvama/ya	sarvama/ya
sarvameDa	sa/rvameDa/	sarvameDa/
sarvarAj	sa/rvarA/j	sarvarA/j
sarvarAtra	sa/rvarAtra	sarvarAtra/
sarvarUpa	sa/rvarUpa	sarva/rUpa
sarvarohita	sa/rvarohita	sarva/rohita
sarvaloka	sa/rvaloka/	sarvaloka/
sarvavid	sa/rvavid	sarvavi/d
sarvavidyA	sa/rvavidyA/,sa/rvavidyA	sarvavidyA/
sarvavedasa	sa/rvavedasa/	sarvavedasa/
sarvaSas	sa/rvaSa/s,sarvaSa/s	sarvaSa/s
sarvaSAnti	sa/rvaSAnti/	sarvaSAnti/
sarvaSAsa	sa/rvaSAsa/	sarvaSAsa/
sarvaSudDavAla	sa/rvaSudDavAla	sarva/SudDavAla
sarvaSveta	sa/rvaSveta	sarva/Sveta,sa/rvaSveta
sarvasamfdDa	sa/rvasamfdDa	sarva/samfdDa
sarvahut	sa/rvahu/t	sarvahu/t
sarvAtman	sarvAtma/n	sarvAtma/n,sa/rvAtman
sarvASya	sarvASya/	sarvASya^
salomatva	sa/lomatva/	salomatva/
savana	sa/vana	sa/vana,savana/
savanaBAj	sa/vanaBA/j	savanaBA/j
savanamuKa	sa/vanamuKa/	savanamuKa/
savIryatva	sa/vIryatva/	savIryatva/
savAtya	savAtya/	savAtya^
savya	savya/	savya/,sa/vya
savyatas	savya/tas	savyata/s
savyazWA	savya/zWA/	savyazWA/
sasTAvan	sasTA/van	sa/sTAvan
sahamAna	sa/hamAna,saha/mAna	sa/hamAna
sahaskft	sa/haskft	sahaskf/t
sahasya	sahasya/	sahasya^
sahacAra	saha/cAra/	sahacAra/
sahaja	saha/ja/	sahaja/
sahajA	saha/jA/	sahajA/
sahadeva	saha/deva	sa/hadeva
sahavah	saha/vah	sahava/h
sahaSeyya	saha/Se/yya	sahaSe/yya
sahasraGni	saha/sraGni/	sahasraGni/
sahasrajit	saha/srajit	sahasraji/t
sahasratama	saha/sratama/	sahasratama/
sahasradA	saha/sradA/	sahasradA/
sahasradAvan	saha/sradA/van	sahasradA/van
sahasraDA	saha/sraDA/	sahasraDA/
sahasrapad	saha/srapad	sahasrapa/d,saha/srapad
sahasrapozin	saha/srapozi/n	sahasrapozi/n
sahasrapozya	saha/srapozya/	sahasrapozya^
sahasrayAjin	saha/srayAjin	sahasrayAji/n
sahasraSatadakziRa	saha/sraSata/dakziRa	sahasraSata/dakziRa
sahasraSas	saha/sraSa/s	sahasraSa/s
sahasrasA	saha/srasA/	sahasrasA/
sahasrasAva	saha/srasAva/	sahasrasAva/
sahasraha	saha/sraha/	sahasraha/
sAkamukz	sAka/mu/kz	sAkamu/kz
sAkameDa	sAka/meDa/	sAkameDa/
sANga	sANga/	sA/Nga
sAtyakAmi	sAtya/kAmi	sA/tyakAmi
sAtyaMkArya	sAtya/MkArya	sAtyaMkArya/
sAtyayajYa	sAtya/yajYa/	sAtyayajYa/
sAtyayajYi	sAtya/yajYi	sA/tyayajYi
sAtyahavya	sAtya/havya/	sAtyahavya/
sADukArin	sADu/kAri/n	sADukAri/n
sADukft	sADu/kf/t	sADukf/t
sADudevin	sADu/devi/n	sADudevi/n
sAmanya	sAmanya/	sAmanya^
sAmrAjya	sA/mrAjya,sA/mrAjya/	sAmrAjya/,sA/mrAjya
sAvitrIputrIya	sAvitrI/putrIya	sAvitrIputrI/ya
sikatya	sikatya/	sikatya^
sinDutas	si/nDuta/s	sinDuta/s
sinDusftya	si/nDusf/tya	sinDusf/tya
sIravAha	sI/ravAha/	sIravAha/
sutapA	suta/pA/	sutapA/
sutapAvan	suta/pA/van	sutapA/van
sutapeya	suta/pe/ya	sutape/ya
suUti	su/Uti/	suUti/
sukanyA	su/kanyA/	sukanyA/
sukaparda	su/kaparda/	sukaparda/
sukara	su/ka/ra	suka/ra
sukarman	su/karman	suka/rman
sukiMSuka	su/kiMSuka/	sukiMSuka/
sukIrti	su/kIrti/	sukIrti/
sukumArIka	su/kumArIka	sukumArI/ka
sukurIra	su/kurIra/	sukurIra/
sukft	su/kf/t	sukf/t
sukfta	su/kfta/,su/kfta	sukfta/,su/kfta
sukftya	su/kftya,su/kftya/	sukftya/
sukftyA	su/kftyA/	sukftyA/
sukftvan	su/kf/tvan	sukf/tvan
suketa	su/ke/ta	suke/ta
suketu	su/ketu/	suketu/
sukratu	su/kra/tu	sukra/tu
sukratUyA	su/kratUyA	sukratUyA/
sukzatra	su/kzatra/	sukzatra/
sukzaya	su/kza/ya	sukza/ya
sukziti	su/kziti/	sukziti/
sukzetra	su/kze/tra	sukze/tra
sukzetratA	su/kze/tra/tA	sukzetra/tA
sukzetriyA	su/kzetriyA	sukzetriyA/
sukzeman	su/kze/man	sukze/man
sukzma	su/kzma/	sukzma/
suKa	su/Ka/,suKa/	suKa/
suKAdi	su/KAdi	suKAdi/
suganDitejana	suga/nDitejana	suganDite/jana
sujAta	sujAta/	su/jAta,sujAta/
sudarSa	suda/rSa	su/darSa
sudinatva	sudi/natva/	sudinatva/
sudinAha	sudi/nAha	sudinAha/
sudevya	sudevya/	sudevya^
supaTya	supaTya/	supaTya^
supraketa	supraketa/	supraketa/,supra/keta
suprAvya	suprAvya/	suprAvya^
suPala	suPa/la,suPala/	suPa/la
suBagaMkaraRa	suBa/ga/MkaraRa	suBaga/MkaraRa
suBagatva	suBa/gatva/	suBagatva/
suptapralapita	supta/pralapita	suptapralapita/
sumeDa	sumeDa/	sumeDa/,sume/Da
sumnahU	sumna/hU/	sumnahU/
suyavasAd	suya/vasA/d	suyavasA/d
suyavasin	suya/vasi/n	suyavasi/n
suyavasyu	suya/vasyu/	suyavasyu/
suyaSas	su/yaSas	suya/Sas
surUpakftnu	surUpa/kftnu/	surUpakftnu/
suvIra	suvI/ra	su/vIra,suvI/ra
suvIratA	suvI/ra/tA	suvIra/tA
suraBiganDi	suraBi/ganDi	suraBiganDi/
surAkAra	su/rAkAra/	surAkAra/
surADAna	su/rADA/na	surADA/na
surApARa	su/rApA/Ra	surApA/Ra
surApIta	su/rApIta	surApIta/
surAma	su/rAma	surA/ma
surASU	su/rASU/	surASU/
surAsoma	su/rAsoma/	surAsoma/
suSevya	suSe/vya	suSe^vya
suzWuvah	suzWu/va/h	suzWuva/h
sUnu	sUnu/	sU/nu
sUktavAka	sUkta/vAka/	sUktavAka/
sUktavAc	sUkta/vA/c	sUktavA/c,sUkta/vAc
sUrI	sU/rI,sUrI/	sUrI/
sUryaSvit	sU/ryaSvi/t	sUryaSvi/t
sUryastut	sU/ryastu/t	sUryastu/t
sUrmya	sUrmya/	sUrmya^
sfdAku	sf/dAku	sfdA/ku
senAjU	se/nAjU/	senAjU/
senAnI	se/nAnI/	senAnI/
senAmuKa	se/nAmuKa/	senAmuKa/
soBarIyu	soBarIyu/	soBarI/yu
somakrayaRa	so/makra/yaRa	somakra/yaRa
somagraha	so/magraha/	somagraha/
somacakzas	so/macakzas	soma/cakzas
somajamBan	so/majamBan	somajamBa/n
somajA	so/majA/	somajA/
somaDAna	so/maDA/na	somaDA/na
somapa	so/mapa/	somapa/
somaparibAD	so/maparibA/D	somaparibA/D
somaparvan	so/mapa/rvan	somapa/rvan
somapA	so/mapA/	somapA/
somapAna	so/mapAna,so/mapA/na	somapA/na
somapAvan	so/mapA/van	somapA/van
somapitsaru	so/mapi/tsaru	somapi/tsaru
somapITa	so/mapITa/	somapITa/
somapITin	so/mapITi/n	somapITi/n
somapeya	so/mape/ya	somape/ya
somaBft	so/maBf/t	somaBf/t
somamad	so/mama/d	somama/d
somamada	so/mamada/	somamada/
somamaya	so/mamaya	somama/ya
somayAjin	so/mayAji/n	somayAji/n
somayoga	so/mayoga/	somayoga/
somarakza	so/marakza/	somarakza/
somarUpa	so/marUpa,so/marUpa/	somarUpa/
somavikrayin	so/mavikrayi/n	somavikrayi/n
somasut	so/masu/t	somasu/t
somasutyA	so/masutyA/	somasutyA/
somasutvan	so/masu/tvan	somasu/tvan
sOBagatva	sO/Bagatva/	sOBagatva/
sOrya	sO/rya	sOrya/
sOryayAma	sO/ryayAma	sOryayAma/
sOryavarcasa	sO/ryavarcasa/	sOryavarcasa/
skamBasarjana	skamBa/sa/rjana	skamBasa/rjana
skamBana	skamBana/	ska/mBana
stambaGana	stamba/Gana	stambaGana/
stambaGna	stamba/Gna	stambaGna/
stambaja	stamba/ja/	stambaja/
stambayajus	stamba/yajus	stambayaju/s
stambaSas	stamba/Sa/s	stambaSa/s
stipA	sti/pA/,stipA/	stipA/
stomamaya	sto/mama/ya	stomama/ya
stomavarDana	sto/mava/rDana	stomava/rDana
stukAvin	stu/kAvi/n	stukAvi/n
stokaSas	stoka/Sas	stokaSa/s
steyakft	ste/yakf/t	steyakf/t
strIpuMsa	strI/puMsa	strIpuMsa/
strIprajYA	strI/prajYA/	strIprajYA/
strIzaMsAda	strI/zaMsAda/	strIzaMsAda/
strIzaKa	strI/zaKa/	strIzaKa/
sTAnapata	sTA/napata	sTAnapata/
sTititA	sTi/titA	sTiti/tA
sTURArAja	sTU/RArAja/	sTURArAja/
sTUri	sTUri/	sTU/ri
snAvanya	snAvanya/	snAvanya^
syonakft	syona/kf/t	syonakf/t
syonaSI	syona/SI	syonaSI/
srotasya	srotasya/	srotasya^
svakAmin	sva/kAmi/n	svakAmi/n
svaja	sva/ja/	svaja/
svaDA	sva/DA,svaDA/	svaDA/
svapati	sva/pati,sva/pati/	sva/pati
svapU	sva/pU/,svapU/	svapU/
svaByasa	sva/Byasa/	svaByasa/
svayu	sva/yu/,svayu/	svayu/
svayugvan	sva/yu/gvan	svayu/gvan
svayuj	sva/yu/j	svayu/j
svarAj	sva/rA/j	svarA/j
svarAjan	sva/rA/jan	svarA/jan
svarAjya	sva/rA/jya	svarA/jya
svavfj	sva/vfj	svavf/j
svasic	sva/si/c	svasi/c
svasft	sva/sft	svasf/t
svaDAkAra	svaDA/kAra/	svaDAkAra/
svayamavapanna	svaya/mavapanna/	svayamavapanna/
svayamAtfRRa	svaya/mAtfRRa	svayamAtfRRa/
svayamudita	svaya/mudita/	svayamudita/
svayamupeta	svaya/mupeta/	svayamupeta/
svAdukzadman	svAdu/kza/dman	svAdukza/dman
svAdurAti	svAdu/rAti/	svAdurAti/
svAduzaMsad	svAdu/zaMsa/d	svAduzaMsa/d
svAdman	svAdma/n,svA/dma/n	svAdma/n,svA/dman
svaDvaryu	sva/Dvaryu	sva^Dvaryu
svapnanaMSana	sva/pnanaMSana	svapnana/MSana
svapas	sva/pas	sva/pas,svapa/s
svapasya	svapasya/	svapasya^
svaBigUrta	sva/BigUrta	sva^BigUrta
svaByakta	sva/Byakta	sva^Byakta
svar	sva/r	sva^r
svarga	sva/rga,svarga/	svarga/
svarcakzas	sva/rcakzas	sva^rcakzas
svarcanas	sva/rcanas	sva^rcanas
svarjit	sva/rji/t	svarji/t
svarjeza	sva/rjeza/	svarjeza/
svardfS	sva/rdf/S	svardf/S
svarmI|a	sva/rmI|a	sva^rmI|a
svarvid	sva/rvi/d	svarvi/d
svarzA	sva/rzA/	svarzA/
svarzAti	sva/rzAti	sva^rzAti
svargya	svargya/	svargya^
svasftva	sva/sftva/	svasftva/
svastigA	svasti/gA/	svastigA/
svastidA	svasti/dA/	svastidA/
svastivah	svasti/vah	svastiva/h
svastivAhana	svasti/vA/hana	svastivA/hana
svAgrayaRa	svA/grayaRa	svA^grayaRa
svAtata	svA/tata	svA^tata
svAhAkAra	svA/hAkAra/	svAhAkAra/
svAhya	svAhya/	svAhya^
svAhuta	svA/huta	svA^huta
svizwa	svi/zwa	svi^zwa
svizwakft	svi/zwakf/t	svizwakf/t
svara	sva/ra	svara/
svarya	svarya/	svarya^
svetavya	sve/tavya	sve^tavya
haMsasAci	haMsa/sA/ci	haMsasA/ci
hanavya	hanavya/	hanavya^
hantakAra	ha/ntakAra/	hantakAra/
harasvin	ha/rasvi/n	harasvi/n
hArya	hArya/	hA/rya
haridru	ha/ridru,hari/dru	hari/dru
haripA	ha/ripA/	haripA/
hariyUpIyA	ha/riyUpI/yA	hariyUpI/yA
hariyojana	ha/riyo/jana	hariyo/jana
hariSaya	ha/riSaya/	hariSaya/
hariSrI	ha/riSrI/	hariSrI/
harizac	ha/riza/c	hariza/c
harizWA	ha/rizWA/	harizWA/
haritajamBan	ha/ritajamBan	haritajamBa/n
haritaBezaja	ha/ritaBezaja/	haritaBezaja/
havirmaTi	havirma/Ti	havi/rma/Ti
havizya	havizya/	havizya^
havyavah	havya/va/h	havyava/h
havyavAha	havya/vAha/	havyavAha/
havyavAhana	havya/vA/hana	havyavA/hana
havyaSoDana	havya/So/Dana	havyaSo/Dana
havyasUd	havya/sU/d	havyasU/d
havyasUdana	havya/sU/dana	havyasU/dana
havanaSrut	ha/vanaSru/t	havanaSru/t
havanasyad	ha/vanasya/d	havanasya/d
hastagfhya	ha/stagfhya	hastagf/hya
hastagrABa	ha/stagrABa/	hastagrABa/
hastaGna	ha/staGna/	hastaGna/
hArda	hA/rda	hArda/
hiNkAra	hi/NkAra/	hiNkAra/
himavata	hima/vata	himavata/
heman	he/man,hema/n	hema/n,he/man
hiraRyakaSipu	hiraRyakaSipu/,hi/raRyakaSipu/	hiraRyakaSipu/,hi/raRyakaSipu
hiraRyajyotis	hiraRyajyoti/s	hiraRyajyoti/s,hi/raRyajyotis
hiraRyaraTa	hiraRyaraTa/,hi/raRyaraTa/	hiraRyaraTa/,hi/raRyaraTa
hfdgolIya	hf/dgolIya	hfdgolI/ya
hfdbala	hf/dbala/	hfdbala/
hfdroga	hf/droga/	hfdroga/
hfdayaja	hf/dayaja/	hfdayaja/
hfdayaSUla	hf/dayaSUla/	hfdayaSUla/
hfdayaSriz	hf/dayaSri/z	hfdayaSri/z
hfdayya	hfdayya/	hfdayya^
hemantajabDa	hemanta/jabDa	hemantaja/bDa
hEraRyanABa	hEraRya/nABa/	hEraRyanABa/
hotfcamasa	ho/tfcamasa/	hotfcamasa/
hotftva	ho/tftva/	hotftva/
hotfvarya	ho/tfva/rya	hotfva/rya
hotfvUrya	ho/tfvU/rya	hotfvU/rya
hotfzadana	ho/tfza/dana	hotfza/dana
hotravah	hotra/va/h	hotrava/h
hradayya	hradayya/	hradayya^
hradecakzus	hradeca/kzus	hrade/cakzus
hotrAvid	ho/trAvid	hotrAvi/d
